"date","geography","geography code","Rural Urban","Tenure: All households; measures: Value","Tenure: Owned; measures: Value","Tenure: Owned: Owned outright; measures: Value","Tenure: Owned: Owned with a mortgage or loan; measures: Value","Tenure: Shared ownership (part owned and part rented); measures: Value","Tenure: Social rented; measures: Value","Tenure: Social rented: Rented from council (Local Authority); measures: Value","Tenure: Social rented: Other; measures: Value","Tenure: Private rented; measures: Value","Tenure: Private rented: Private landlord or letting agency; measures: Value","Tenure: Private rented: Other; measures: Value","Tenure: Living rent free; measures: Value"
"2011","Darlington","E06000005","Total",46670,30289,13810,16479,178,7228,5238,1990,8513,7758,755,462
"2011","Darlington","E06000005","Urban (total)",41123,25897,11659,14238,158,6884,4941,1943,7796,7130,666,388
"2011","Darlington","E06000005","Urban major conurbation",0,0,0,0,0,0,0,0,0,0,0,0
"2011","Darlington","E06000005","Urban minor conurbation",0,0,0,0,0,0,0,0,0,0,0,0
"2011","Darlington","E06000005","Urban city and town",41123,25897,11659,14238,158,6884,4941,1943,7796,7130,666,388
"2011","Darlington","E06000005","Urban city and town in a sparse setting",0,0,0,0,0,0,0,0,0,0,0,0
"2011","Darlington","E06000005","Rural (total)",5547,4392,2151,2241,20,344,297,47,717,628,89,74
"2011","Darlington","E06000005","Rural town and fringe",3294,2635,1194,1441,18,235,195,40,378,345,33,28
"2011","Darlington","E06000005","Rural town and fringe in a sparse setting",0,0,0,0,0,0,0,0,0,0,0,0
"2011","Darlington","E06000005","Rural village",1532,1246,677,569,2,60,55,5,199,166,33,25
"2011","Darlington","E06000005","Rural village in a sparse setting",0,0,0,0,0,0,0,0,0,0,0,0
"2011","Darlington","E06000005","Rural hamlet and isolated dwellings",721,511,280,231,0,49,47,2,140,117,23,21
"2011","Darlington","E06000005","Rural hamlet and isolated dwellings in a sparse setting",0,0,0,0,0,0,0,0,0,0,0,0
"2011","County Durham","E06000047","Total",223803,147347,69435,77912,488,45004,28559,16445,28142,25498,2644,2822
"2011","County Durham","E06000047","Urban (total)",120268,78448,35991,42457,281,24391,15005,9386,15794,14422,1372,1354
"2011","County Durham","E06000047","Urban major conurbation",17422,12416,5494,6922,63,3139,1196,1943,1644,1471,173,160
"2011","County Durham","E06000047","Urban minor conurbation",0,0,0,0,0,0,0,0,0,0,0,0
"2011","County Durham","E06000047","Urban city and town",102846,66032,30497,35535,218,21252,13809,7443,14150,12951,1199,1194
"2011","County Durham","E06000047","Urban city and town in a sparse setting",0,0,0,0,0,0,0,0,0,0,0,0
"2011","County Durham","E06000047","Rural (total)",103535,68899,33444,35455,207,20613,13554,7059,12348,11076,1272,1468
"2011","County Durham","E06000047","Rural town and fringe",80160,51746,24355,27391,155,17927,11934,5993,9344,8420,924,988
"2011","County Durham","E06000047","Rural town and fringe in a sparse setting",126,88,64,24,0,16,2,14,20,19,1,2
"2011","County Durham","E06000047","Rural village",14804,10745,5510,5235,31,2132,1307,825,1664,1477,187,232
"2011","County Durham","E06000047","Rural village in a sparse setting",1182,835,535,300,4,105,54,51,198,162,36,40
"2011","County Durham","E06000047","Rural hamlet and isolated dwellings",6425,4913,2620,2293,15,412,246,166,924,813,111,161
"2011","County Durham","E06000047","Rural hamlet and isolated dwellings in a sparse setting",838,572,360,212,2,21,11,10,198,185,13,45
"2011","Hartlepool","E06000001","Total",40434,24194,11090,13104,200,9515,4016,5499,5971,5525,446,554
"2011","Hartlepool","E06000001","Urban (total)",39054,23265,10616,12649,171,9268,3958,5310,5811,5393,418,539
"2011","Hartlepool","E06000001","Urban major conurbation",0,0,0,0,0,0,0,0,0,0,0,0
"2011","Hartlepool","E06000001","Urban minor conurbation",0,0,0,0,0,0,0,0,0,0,0,0
"2011","Hartlepool","E06000001","Urban city and town",39054,23265,10616,12649,171,9268,3958,5310,5811,5393,418,539
"2011","Hartlepool","E06000001","Urban city and town in a sparse setting",0,0,0,0,0,0,0,0,0,0,0,0
"2011","Hartlepool","E06000001","Rural (total)",1380,929,474,455,29,247,58,189,160,132,28,15
"2011","Hartlepool","E06000001","Rural town and fringe",392,179,82,97,28,142,24,118,39,33,6,4
"2011","Hartlepool","E06000001","Rural town and fringe in a sparse setting",0,0,0,0,0,0,0,0,0,0,0,0
"2011","Hartlepool","E06000001","Rural village",657,540,293,247,1,53,19,34,56,43,13,7
"2011","Hartlepool","E06000001","Rural village in a sparse setting",0,0,0,0,0,0,0,0,0,0,0,0
"2011","Hartlepool","E06000001","Rural hamlet and isolated dwellings",331,210,99,111,0,52,15,37,65,56,9,4
"2011","Hartlepool","E06000001","Rural hamlet and isolated dwellings in a sparse setting",0,0,0,0,0,0,0,0,0,0,0,0
"2011","Middlesbrough","E06000002","Total",57203,32723,15200,17523,336,13654,6049,7605,9509,8648,861,981
"2011","Middlesbrough","E06000002","Urban (total)",56870,32465,15114,17351,331,13615,6041,7574,9483,8625,858,976
"2011","Middlesbrough","E06000002","Urban major conurbation",0,0,0,0,0,0,0,0,0,0,0,0
"2011","Middlesbrough","E06000002","Urban minor conurbation",0,0,0,0,0,0,0,0,0,0,0,0
"2011","Middlesbrough","E06000002","Urban city and town",56870,32465,15114,17351,331,13615,6041,7574,9483,8625,858,976
"2011","Middlesbrough","E06000002","Urban city and town in a sparse setting",0,0,0,0,0,0,0,0,0,0,0,0
"2011","Middlesbrough","E06000002","Rural (total)",333,258,86,172,5,39,8,31,26,23,3,5
"2011","Middlesbrough","E06000002","Rural town and fringe",204,157,40,117,5,29,1,28,11,10,1,2
"2011","Middlesbrough","E06000002","Rural town and fringe in a sparse setting",0,0,0,0,0,0,0,0,0,0,0,0
"2011","Middlesbrough","E06000002","Rural village",129,101,46,55,0,10,7,3,15,13,2,3
"2011","Middlesbrough","E06000002","Rural village in a sparse setting",0,0,0,0,0,0,0,0,0,0,0,0
"2011","Middlesbrough","E06000002","Rural hamlet and isolated dwellings",0,0,0,0,0,0,0,0,0,0,0,0
"2011","Middlesbrough","E06000002","Rural hamlet and isolated dwellings in a sparse setting",0,0,0,0,0,0,0,0,0,0,0,0
"2011","Northumberland","E06000048","Total",138534,91207,46086,45121,510,25841,14820,11021,18417,16225,2192,2559
"2011","Northumberland","E06000048","Urban (total)",74511,49343,23436,25907,260,15444,9003,6441,8588,7633,955,876
"2011","Northumberland","E06000048","Urban major conurbation",11418,8562,3638,4924,40,1728,1291,437,978,853,125,110
"2011","Northumberland","E06000048","Urban minor conurbation",0,0,0,0,0,0,0,0,0,0,0,0
"2011","Northumberland","E06000048","Urban city and town",57159,37202,17816,19386,199,12305,7333,4972,6784,6044,740,669
"2011","Northumberland","E06000048","Urban city and town in a sparse setting",5934,3579,1982,1597,21,1411,379,1032,826,736,90,97
"2011","Northumberland","E06000048","Rural (total)",64023,41864,22650,19214,250,10397,5817,4580,9829,8592,1237,1683
"2011","Northumberland","E06000048","Rural town and fringe",23674,15703,7612,8091,96,5048,3219,1829,2517,2257,260,310
"2011","Northumberland","E06000048","Rural town and fringe in a sparse setting",13133,8096,4538,3558,53,2888,1647,1241,1831,1502,329,265
"2011","Northumberland","E06000048","Rural village",5498,4110,2194,1916,11,660,323,337,621,528,93,96
"2011","Northumberland","E06000048","Rural village in a sparse setting",7724,5324,3238,2086,48,1170,424,746,989,840,149,193
"2011","Northumberland","E06000048","Rural hamlet and isolated dwellings",6552,4409,2440,1969,20,293,81,212,1559,1407,152,271
"2011","Northumberland","E06000048","Rural hamlet and isolated dwellings in a sparse setting",7442,4222,2628,1594,22,338,123,215,2312,2058,254,548
"2011","Redcar and Cleveland","E06000003","Total",59605,39705,19806,19899,256,11568,5999,5569,7434,6698,736,642
"2011","Redcar and Cleveland","E06000003","Urban (total)",40079,26194,12643,13551,205,8663,4688,3975,4605,4129,476,412
"2011","Redcar and Cleveland","E06000003","Urban major conurbation",0,0,0,0,0,0,0,0,0,0,0,0
"2011","Redcar and Cleveland","E06000003","Urban minor conurbation",0,0,0,0,0,0,0,0,0,0,0,0
"2011","Redcar and Cleveland","E06000003","Urban city and town",40079,26194,12643,13551,205,8663,4688,3975,4605,4129,476,412
"2011","Redcar and Cleveland","E06000003","Urban city and town in a sparse setting",0,0,0,0,0,0,0,0,0,0,0,0
"2011","Redcar and Cleveland","E06000003","Rural (total)",19526,13511,7163,6348,51,2905,1311,1594,2829,2569,260,230
"2011","Redcar and Cleveland","E06000003","Rural town and fringe",17203,11990,6277,5713,47,2540,1125,1415,2451,2237,214,175
"2011","Redcar and Cleveland","E06000003","Rural town and fringe in a sparse setting",0,0,0,0,0,0,0,0,0,0,0,0
"2011","Redcar and Cleveland","E06000003","Rural village",1461,878,496,382,2,341,177,164,214,190,24,26
"2011","Redcar and Cleveland","E06000003","Rural village in a sparse setting",0,0,0,0,0,0,0,0,0,0,0,0
"2011","Redcar and Cleveland","E06000003","Rural hamlet and isolated dwellings",862,643,390,253,2,24,9,15,164,142,22,29
"2011","Redcar and Cleveland","E06000003","Rural hamlet and isolated dwellings in a sparse setting",0,0,0,0,0,0,0,0,0,0,0,0
"2011","Stockton-on-Tees","E06000004","Total",79159,54225,23285,30940,255,13625,7285,6340,10387,9417,970,667
"2011","Stockton-on-Tees","E06000004","Urban (total)",76154,51615,22075,29540,252,13499,7208,6291,10155,9213,942,633
"2011","Stockton-on-Tees","E06000004","Urban major conurbation",0,0,0,0,0,0,0,0,0,0,0,0
"2011","Stockton-on-Tees","E06000004","Urban minor conurbation",0,0,0,0,0,0,0,0,0,0,0,0
"2011","Stockton-on-Tees","E06000004","Urban city and town",76154,51615,22075,29540,252,13499,7208,6291,10155,9213,942,633
"2011","Stockton-on-Tees","E06000004","Urban city and town in a sparse setting",0,0,0,0,0,0,0,0,0,0,0,0
"2011","Stockton-on-Tees","E06000004","Rural (total)",3005,2610,1210,1400,3,126,77,49,232,204,28,34
"2011","Stockton-on-Tees","E06000004","Rural town and fringe",155,123,37,86,1,19,14,5,12,10,2,0
"2011","Stockton-on-Tees","E06000004","Rural town and fringe in a sparse setting",0,0,0,0,0,0,0,0,0,0,0,0
"2011","Stockton-on-Tees","E06000004","Rural village",2377,2070,968,1102,2,97,55,42,183,162,21,25
"2011","Stockton-on-Tees","E06000004","Rural village in a sparse setting",0,0,0,0,0,0,0,0,0,0,0,0
"2011","Stockton-on-Tees","E06000004","Rural hamlet and isolated dwellings",473,417,205,212,0,10,8,2,37,32,5,9
"2011","Stockton-on-Tees","E06000004","Rural hamlet and isolated dwellings in a sparse setting",0,0,0,0,0,0,0,0,0,0,0,0
"2011","Gateshead","E08000020","Total",89154,51915,23081,28834,363,24941,19985,4956,11125,10130,995,810
"2011","Gateshead","E08000020","Urban (total)",82008,47013,20609,26404,331,23585,18788,4797,10336,9406,930,743
"2011","Gateshead","E08000020","Urban major conurbation",80709,46051,20168,25883,323,23418,18644,4774,10181,9264,917,736
"2011","Gateshead","E08000020","Urban minor conurbation",0,0,0,0,0,0,0,0,0,0,0,0
"2011","Gateshead","E08000020","Urban city and town",1299,962,441,521,8,167,144,23,155,142,13,7
"2011","Gateshead","E08000020","Urban city and town in a sparse setting",0,0,0,0,0,0,0,0,0,0,0,0
"2011","Gateshead","E08000020","Rural (total)",7146,4902,2472,2430,32,1356,1197,159,789,724,65,67
"2011","Gateshead","E08000020","Rural town and fringe",5791,3805,1914,1891,25,1244,1096,148,672,621,51,45
"2011","Gateshead","E08000020","Rural town and fringe in a sparse setting",0,0,0,0,0,0,0,0,0,0,0,0
"2011","Gateshead","E08000020","Rural village",691,563,310,253,6,69,63,6,47,39,8,6
"2011","Gateshead","E08000020","Rural village in a sparse setting",0,0,0,0,0,0,0,0,0,0,0,0
"2011","Gateshead","E08000020","Rural hamlet and isolated dwellings",664,534,248,286,1,43,38,5,70,64,6,16
"2011","Gateshead","E08000020","Rural hamlet and isolated dwellings in a sparse setting",0,0,0,0,0,0,0,0,0,0,0,0
"2011","Newcastle upon Tyne","E08000021","Total",117153,57955,26258,31697,489,34850,27340,7510,22318,20462,1856,1541
"2011","Newcastle upon Tyne","E08000021","Urban (total)",114611,56397,25543,30854,489,34164,26851,7313,22043,20210,1833,1518
"2011","Newcastle upon Tyne","E08000021","Urban major conurbation",114354,56181,25421,30760,489,34151,26846,7305,22015,20183,1832,1518
"2011","Newcastle upon Tyne","E08000021","Urban minor conurbation",0,0,0,0,0,0,0,0,0,0,0,0
"2011","Newcastle upon Tyne","E08000021","Urban city and town",257,216,122,94,0,13,5,8,28,27,1,0
"2011","Newcastle upon Tyne","E08000021","Urban city and town in a sparse setting",0,0,0,0,0,0,0,0,0,0,0,0
"2011","Newcastle upon Tyne","E08000021","Rural (total)",2542,1558,715,843,0,686,489,197,275,252,23,23
"2011","Newcastle upon Tyne","E08000021","Rural town and fringe",1848,1055,508,547,0,587,459,128,194,179,15,12
"2011","Newcastle upon Tyne","E08000021","Rural town and fringe in a sparse setting",0,0,0,0,0,0,0,0,0,0,0,0
"2011","Newcastle upon Tyne","E08000021","Rural village",694,503,207,296,0,99,30,69,81,73,8,11
"2011","Newcastle upon Tyne","E08000021","Rural village in a sparse setting",0,0,0,0,0,0,0,0,0,0,0,0
"2011","Newcastle upon Tyne","E08000021","Rural hamlet and isolated dwellings",0,0,0,0,0,0,0,0,0,0,0,0
"2011","Newcastle upon Tyne","E08000021","Rural hamlet and isolated dwellings in a sparse setting",0,0,0,0,0,0,0,0,0,0,0,0
"2011","North Tyneside","E08000022","Total",91295,59136,25611,33525,374,19677,14610,5067,11300,10146,1154,808
"2011","North Tyneside","E08000022","Urban (total)",87306,56137,24043,32094,372,19064,14148,4916,10964,9884,1080,769
"2011","North Tyneside","E08000022","Urban major conurbation",86552,55662,23905,31757,366,18887,14015,4872,10877,9800,1077,760
"2011","North Tyneside","E08000022","Urban minor conurbation",0,0,0,0,0,0,0,0,0,0,0,0
"2011","North Tyneside","E08000022","Urban city and town",754,475,138,337,6,177,133,44,87,84,3,9
"2011","North Tyneside","E08000022","Urban city and town in a sparse setting",0,0,0,0,0,0,0,0,0,0,0,0
"2011","North Tyneside","E08000022","Rural (total)",3989,2999,1568,1431,2,613,462,151,336,262,74,39
"2011","North Tyneside","E08000022","Rural town and fringe",3747,2881,1538,1343,2,512,368,144,316,244,72,36
"2011","North Tyneside","E08000022","Rural town and fringe in a sparse setting",0,0,0,0,0,0,0,0,0,0,0,0
"2011","North Tyneside","E08000022","Rural village",114,45,6,39,0,61,60,1,7,6,1,1
"2011","North Tyneside","E08000022","Rural village in a sparse setting",0,0,0,0,0,0,0,0,0,0,0,0
"2011","North Tyneside","E08000022","Rural hamlet and isolated dwellings",128,73,24,49,0,40,34,6,13,12,1,2
"2011","North Tyneside","E08000022","Rural hamlet and isolated dwellings in a sparse setting",0,0,0,0,0,0,0,0,0,0,0,0
"2011","South Tyneside","E08000023","Total",67167,38333,17003,21330,297,21204,16967,4237,6758,6040,718,575
"2011","South Tyneside","E08000023","Urban (total)",66914,38203,16949,21254,294,21121,16886,4235,6725,6014,711,571
"2011","South Tyneside","E08000023","Urban major conurbation",64222,36277,15911,20366,290,20551,16341,4210,6558,5869,689,546
"2011","South Tyneside","E08000023","Urban minor conurbation",0,0,0,0,0,0,0,0,0,0,0,0
"2011","South Tyneside","E08000023","Urban city and town",2692,1926,1038,888,4,570,545,25,167,145,22,25
"2011","South Tyneside","E08000023","Urban city and town in a sparse setting",0,0,0,0,0,0,0,0,0,0,0,0
"2011","South Tyneside","E08000023","Rural (total)",253,130,54,76,3,83,81,2,33,26,7,4
"2011","South Tyneside","E08000023","Rural town and fringe",136,45,12,33,1,76,76,0,13,10,3,1
"2011","South Tyneside","E08000023","Rural town and fringe in a sparse setting",0,0,0,0,0,0,0,0,0,0,0,0
"2011","South Tyneside","E08000023","Rural village",0,0,0,0,0,0,0,0,0,0,0,0
"2011","South Tyneside","E08000023","Rural village in a sparse setting",0,0,0,0,0,0,0,0,0,0,0,0
"2011","South Tyneside","E08000023","Rural hamlet and isolated dwellings",117,85,42,43,2,7,5,2,20,16,4,3
"2011","South Tyneside","E08000023","Rural hamlet and isolated dwellings in a sparse setting",0,0,0,0,0,0,0,0,0,0,0,0
"2011","Sunderland","E08000024","Total",119758,71566,32419,39147,352,32399,16725,15674,14552,13077,1475,889
"2011","Sunderland","E08000024","Urban (total)",119073,71130,32200,38930,350,32199,16607,15592,14511,13037,1474,883
"2011","Sunderland","E08000024","Urban major conurbation",118686,70954,32119,38835,350,32018,16499,15519,14481,13010,1471,883
"2011","Sunderland","E08000024","Urban minor conurbation",0,0,0,0,0,0,0,0,0,0,0,0
"2011","Sunderland","E08000024","Urban city and town",387,176,81,95,0,181,108,73,30,27,3,0
"2011","Sunderland","E08000024","Urban city and town in a sparse setting",0,0,0,0,0,0,0,0,0,0,0,0
"2011","Sunderland","E08000024","Rural (total)",685,436,219,217,2,200,118,82,41,40,1,6
"2011","Sunderland","E08000024","Rural town and fringe",559,344,164,180,2,183,108,75,25,24,1,5
"2011","Sunderland","E08000024","Rural town and fringe in a sparse setting",0,0,0,0,0,0,0,0,0,0,0,0
"2011","Sunderland","E08000024","Rural village",0,0,0,0,0,0,0,0,0,0,0,0
"2011","Sunderland","E08000024","Rural village in a sparse setting",0,0,0,0,0,0,0,0,0,0,0,0
"2011","Sunderland","E08000024","Rural hamlet and isolated dwellings",126,92,55,37,0,17,10,7,16,16,0,1
"2011","Sunderland","E08000024","Rural hamlet and isolated dwellings in a sparse setting",0,0,0,0,0,0,0,0,0,0,0,0
"2011","Blackburn with Darwen","E06000008","Total",57353,36793,18039,18754,290,10391,3228,7163,8993,8113,880,886
"2011","Blackburn with Darwen","E06000008","Urban (total)",54428,34193,16736,17457,290,10355,3220,7135,8731,7889,842,859
"2011","Blackburn with Darwen","E06000008","Urban major conurbation",0,0,0,0,0,0,0,0,0,0,0,0
"2011","Blackburn with Darwen","E06000008","Urban minor conurbation",0,0,0,0,0,0,0,0,0,0,0,0
"2011","Blackburn with Darwen","E06000008","Urban city and town",54428,34193,16736,17457,290,10355,3220,7135,8731,7889,842,859
"2011","Blackburn with Darwen","E06000008","Urban city and town in a sparse setting",0,0,0,0,0,0,0,0,0,0,0,0
"2011","Blackburn with Darwen","E06000008","Rural (total)",2925,2600,1303,1297,0,36,8,28,262,224,38,27
"2011","Blackburn with Darwen","E06000008","Rural town and fringe",1139,1022,519,503,0,19,0,19,87,71,16,11
"2011","Blackburn with Darwen","E06000008","Rural town and fringe in a sparse setting",0,0,0,0,0,0,0,0,0,0,0,0
"2011","Blackburn with Darwen","E06000008","Rural village",1020,889,439,450,0,12,4,8,111,94,17,8
"2011","Blackburn with Darwen","E06000008","Rural village in a sparse setting",0,0,0,0,0,0,0,0,0,0,0,0
"2011","Blackburn with Darwen","E06000008","Rural hamlet and isolated dwellings",766,689,345,344,0,5,4,1,64,59,5,8
"2011","Blackburn with Darwen","E06000008","Rural hamlet and isolated dwellings in a sparse setting",0,0,0,0,0,0,0,0,0,0,0,0
"2011","Blackpool","E06000009","Total",64367,39650,19318,20332,239,6999,4823,2176,16770,15549,1221,709
"2011","Blackpool","E06000009","Urban (total)",64149,39489,19270,20219,239,6968,4819,2149,16744,15527,1217,709
"2011","Blackpool","E06000009","Urban major conurbation",0,0,0,0,0,0,0,0,0,0,0,0
"2011","Blackpool","E06000009","Urban minor conurbation",0,0,0,0,0,0,0,0,0,0,0,0
"2011","Blackpool","E06000009","Urban city and town",64149,39489,19270,20219,239,6968,4819,2149,16744,15527,1217,709
"2011","Blackpool","E06000009","Urban city and town in a sparse setting",0,0,0,0,0,0,0,0,0,0,0,0
"2011","Blackpool","E06000009","Rural (total)",218,161,48,113,0,31,4,27,26,22,4,0
"2011","Blackpool","E06000009","Rural town and fringe",218,161,48,113,0,31,4,27,26,22,4,0
"2011","Blackpool","E06000009","Rural town and fringe in a sparse setting",0,0,0,0,0,0,0,0,0,0,0,0
"2011","Blackpool","E06000009","Rural village",0,0,0,0,0,0,0,0,0,0,0,0
"2011","Blackpool","E06000009","Rural village in a sparse setting",0,0,0,0,0,0,0,0,0,0,0,0
"2011","Blackpool","E06000009","Rural hamlet and isolated dwellings",0,0,0,0,0,0,0,0,0,0,0,0
"2011","Blackpool","E06000009","Rural hamlet and isolated dwellings in a sparse setting",0,0,0,0,0,0,0,0,0,0,0,0
"2011","Cheshire East","E06000049","Total",159441,118766,59846,58920,779,18141,4285,13856,19938,18244,1694,1817
"2011","Cheshire East","E06000049","Urban (total)",130657,95688,47123,48565,648,16458,3929,12529,16577,15278,1299,1286
"2011","Cheshire East","E06000049","Urban major conurbation",19812,15362,7932,7430,116,2085,221,1864,2060,1894,166,189
"2011","Cheshire East","E06000049","Urban minor conurbation",0,0,0,0,0,0,0,0,0,0,0,0
"2011","Cheshire East","E06000049","Urban city and town",110845,80326,39191,41135,532,14373,3708,10665,14517,13384,1133,1097
"2011","Cheshire East","E06000049","Urban city and town in a sparse setting",0,0,0,0,0,0,0,0,0,0,0,0
"2011","Cheshire East","E06000049","Rural (total)",28784,23078,12723,10355,131,1683,356,1327,3361,2966,395,531
"2011","Cheshire East","E06000049","Rural town and fringe",8889,7446,4028,3418,32,539,92,447,752,681,71,120
"2011","Cheshire East","E06000049","Rural town and fringe in a sparse setting",0,0,0,0,0,0,0,0,0,0,0,0
"2011","Cheshire East","E06000049","Rural village",8890,7191,3914,3277,58,576,120,456,928,815,113,137
"2011","Cheshire East","E06000049","Rural village in a sparse setting",0,0,0,0,0,0,0,0,0,0,0,0
"2011","Cheshire East","E06000049","Rural hamlet and isolated dwellings",11005,8441,4781,3660,41,568,144,424,1681,1470,211,274
"2011","Cheshire East","E06000049","Rural hamlet and isolated dwellings in a sparse setting",0,0,0,0,0,0,0,0,0,0,0,0
"2011","Cheshire West and Chester","E06000050","Total",141442,100105,49129,50976,1088,20808,10482,10326,17734,16021,1713,1707
"2011","Cheshire West and Chester","E06000050","Urban (total)",105014,71131,32920,38211,823,17840,9372,8468,14052,12781,1271,1168
"2011","Cheshire West and Chester","E06000050","Urban major conurbation",0,0,0,0,0,0,0,0,0,0,0,0
"2011","Cheshire West and Chester","E06000050","Urban minor conurbation",0,0,0,0,0,0,0,0,0,0,0,0
"2011","Cheshire West and Chester","E06000050","Urban city and town",105014,71131,32920,38211,823,17840,9372,8468,14052,12781,1271,1168
"2011","Cheshire West and Chester","E06000050","Urban city and town in a sparse setting",0,0,0,0,0,0,0,0,0,0,0,0
"2011","Cheshire West and Chester","E06000050","Rural (total)",36428,28974,16209,12765,265,2968,1110,1858,3682,3240,442,539
"2011","Cheshire West and Chester","E06000050","Rural town and fringe",19427,15194,8254,6940,153,2117,827,1290,1757,1553,204,206
"2011","Cheshire West and Chester","E06000050","Rural town and fringe in a sparse setting",0,0,0,0,0,0,0,0,0,0,0,0
"2011","Cheshire West and Chester","E06000050","Rural village",8530,6926,4020,2906,64,496,153,343,870,763,107,174
"2011","Cheshire West and Chester","E06000050","Rural village in a sparse setting",0,0,0,0,0,0,0,0,0,0,0,0
"2011","Cheshire West and Chester","E06000050","Rural hamlet and isolated dwellings",8471,6854,3935,2919,48,355,130,225,1055,924,131,159
"2011","Cheshire West and Chester","E06000050","Rural hamlet and isolated dwellings in a sparse setting",0,0,0,0,0,0,0,0,0,0,0,0
"2011","Halton","E06000006","Total",53312,33796,14436,19360,322,13441,2502,10939,5212,4752,460,541
"2011","Halton","E06000006","Urban (total)",52004,32599,13859,18740,320,13416,2493,10923,5137,4685,452,532
"2011","Halton","E06000006","Urban major conurbation",0,0,0,0,0,0,0,0,0,0,0,0
"2011","Halton","E06000006","Urban minor conurbation",0,0,0,0,0,0,0,0,0,0,0,0
"2011","Halton","E06000006","Urban city and town",52004,32599,13859,18740,320,13416,2493,10923,5137,4685,452,532
"2011","Halton","E06000006","Urban city and town in a sparse setting",0,0,0,0,0,0,0,0,0,0,0,0
"2011","Halton","E06000006","Rural (total)",1308,1197,577,620,2,25,9,16,75,67,8,9
"2011","Halton","E06000006","Rural town and fringe",906,815,404,411,2,25,9,16,59,53,6,5
"2011","Halton","E06000006","Rural town and fringe in a sparse setting",0,0,0,0,0,0,0,0,0,0,0,0
"2011","Halton","E06000006","Rural village",305,299,139,160,0,0,0,0,6,5,1,0
"2011","Halton","E06000006","Rural village in a sparse setting",0,0,0,0,0,0,0,0,0,0,0,0
"2011","Halton","E06000006","Rural hamlet and isolated dwellings",97,83,34,49,0,0,0,0,10,9,1,4
"2011","Halton","E06000006","Rural hamlet and isolated dwellings in a sparse setting",0,0,0,0,0,0,0,0,0,0,0,0
"2011","Warrington","E06000007","Total",85140,60915,27206,33709,637,13318,6147,7171,9549,8683,866,721
"2011","Warrington","E06000007","Urban (total)",75391,52749,23059,29690,615,12601,5725,6876,8790,8020,770,636
"2011","Warrington","E06000007","Urban major conurbation",0,0,0,0,0,0,0,0,0,0,0,0
"2011","Warrington","E06000007","Urban minor conurbation",0,0,0,0,0,0,0,0,0,0,0,0
"2011","Warrington","E06000007","Urban city and town",75391,52749,23059,29690,615,12601,5725,6876,8790,8020,770,636
"2011","Warrington","E06000007","Urban city and town in a sparse setting",0,0,0,0,0,0,0,0,0,0,0,0
"2011","Warrington","E06000007","Rural (total)",9749,8166,4147,4019,22,717,422,295,759,663,96,85
"2011","Warrington","E06000007","Rural town and fringe",5938,4899,2561,2338,15,548,313,235,427,370,57,49
"2011","Warrington","E06000007","Rural town and fringe in a sparse setting",0,0,0,0,0,0,0,0,0,0,0,0
"2011","Warrington","E06000007","Rural village",2147,1766,841,925,7,159,104,55,195,173,22,20
"2011","Warrington","E06000007","Rural village in a sparse setting",0,0,0,0,0,0,0,0,0,0,0,0
"2011","Warrington","E06000007","Rural hamlet and isolated dwellings",1664,1501,745,756,0,10,5,5,137,120,17,16
"2011","Warrington","E06000007","Rural hamlet and isolated dwellings in a sparse setting",0,0,0,0,0,0,0,0,0,0,0,0
"2011","Allerdale","E07000026","Total",42345,29217,16686,12531,200,8088,1123,6965,4142,3595,547,698
"2011","Allerdale","E07000026","Urban (total)",12255,7884,4042,3842,56,3090,468,2622,1064,936,128,161
"2011","Allerdale","E07000026","Urban major conurbation",0,0,0,0,0,0,0,0,0,0,0,0
"2011","Allerdale","E07000026","Urban minor conurbation",0,0,0,0,0,0,0,0,0,0,0,0
"2011","Allerdale","E07000026","Urban city and town",12255,7884,4042,3842,56,3090,468,2622,1064,936,128,161
"2011","Allerdale","E07000026","Urban city and town in a sparse setting",0,0,0,0,0,0,0,0,0,0,0,0
"2011","Allerdale","E07000026","Rural (total)",30090,21333,12644,8689,144,4998,655,4343,3078,2659,419,537
"2011","Allerdale","E07000026","Rural town and fringe",13177,8787,4875,3912,61,2899,388,2511,1242,1108,134,188
"2011","Allerdale","E07000026","Rural town and fringe in a sparse setting",4407,2851,1795,1056,29,954,147,807,486,417,69,87
"2011","Allerdale","E07000026","Rural village",5306,4097,2338,1759,11,640,65,575,476,415,61,82
"2011","Allerdale","E07000026","Rural village in a sparse setting",2908,2251,1469,782,16,239,11,228,345,282,63,57
"2011","Allerdale","E07000026","Rural hamlet and isolated dwellings",1686,1379,893,486,8,72,12,60,179,159,20,48
"2011","Allerdale","E07000026","Rural hamlet and isolated dwellings in a sparse setting",2606,1968,1274,694,19,194,32,162,350,278,72,75
"2011","Barrow-in-Furness","E07000027","Total",31224,22938,11423,11515,36,3454,2704,750,4442,4005,437,354
"2011","Barrow-in-Furness","E07000027","Urban (total)",20952,14449,7133,7316,26,2751,2099,652,3492,3167,325,234
"2011","Barrow-in-Furness","E07000027","Urban major conurbation",0,0,0,0,0,0,0,0,0,0,0,0
"2011","Barrow-in-Furness","E07000027","Urban minor conurbation",0,0,0,0,0,0,0,0,0,0,0,0
"2011","Barrow-in-Furness","E07000027","Urban city and town",20952,14449,7133,7316,26,2751,2099,652,3492,3167,325,234
"2011","Barrow-in-Furness","E07000027","Urban city and town in a sparse setting",0,0,0,0,0,0,0,0,0,0,0,0
"2011","Barrow-in-Furness","E07000027","Rural (total)",10272,8489,4290,4199,10,703,605,98,950,838,112,120
"2011","Barrow-in-Furness","E07000027","Rural town and fringe",9497,7786,3901,3885,10,700,602,98,889,786,103,112
"2011","Barrow-in-Furness","E07000027","Rural town and fringe in a sparse setting",0,0,0,0,0,0,0,0,0,0,0,0
"2011","Barrow-in-Furness","E07000027","Rural village",696,632,344,288,0,3,3,0,53,45,8,8
"2011","Barrow-in-Furness","E07000027","Rural village in a sparse setting",0,0,0,0,0,0,0,0,0,0,0,0
"2011","Barrow-in-Furness","E07000027","Rural hamlet and isolated dwellings",79,71,45,26,0,0,0,0,8,7,1,0
"2011","Barrow-in-Furness","E07000027","Rural hamlet and isolated dwellings in a sparse setting",0,0,0,0,0,0,0,0,0,0,0,0
"2011","Carlisle","E07000028","Total",48342,32999,16754,16245,332,7394,1283,6111,6914,6221,693,703
"2011","Carlisle","E07000028","Urban (total)",35734,23369,11045,12324,292,6294,1107,5187,5342,4850,492,437
"2011","Carlisle","E07000028","Urban major conurbation",0,0,0,0,0,0,0,0,0,0,0,0
"2011","Carlisle","E07000028","Urban minor conurbation",0,0,0,0,0,0,0,0,0,0,0,0
"2011","Carlisle","E07000028","Urban city and town",35734,23369,11045,12324,292,6294,1107,5187,5342,4850,492,437
"2011","Carlisle","E07000028","Urban city and town in a sparse setting",0,0,0,0,0,0,0,0,0,0,0,0
"2011","Carlisle","E07000028","Rural (total)",12608,9630,5709,3921,40,1100,176,924,1572,1371,201,266
"2011","Carlisle","E07000028","Rural town and fringe",4385,2979,1652,1327,11,780,128,652,538,461,77,77
"2011","Carlisle","E07000028","Rural town and fringe in a sparse setting",0,0,0,0,0,0,0,0,0,0,0,0
"2011","Carlisle","E07000028","Rural village",4144,3425,2005,1420,18,200,23,177,426,375,51,75
"2011","Carlisle","E07000028","Rural village in a sparse setting",587,478,291,187,3,27,7,20,69,54,15,10
"2011","Carlisle","E07000028","Rural hamlet and isolated dwellings",2558,2052,1313,739,5,51,11,40,373,330,43,77
"2011","Carlisle","E07000028","Rural hamlet and isolated dwellings in a sparse setting",934,696,448,248,3,42,7,35,166,151,15,27
"2011","Copeland","E07000029","Total",30536,21671,11315,10356,96,5668,2172,3496,2665,2315,350,436
"2011","Copeland","E07000029","Urban (total)",10937,7399,3539,3860,61,2475,1184,1291,854,724,130,148
"2011","Copeland","E07000029","Urban major conurbation",0,0,0,0,0,0,0,0,0,0,0,0
"2011","Copeland","E07000029","Urban minor conurbation",0,0,0,0,0,0,0,0,0,0,0,0
"2011","Copeland","E07000029","Urban city and town",10937,7399,3539,3860,61,2475,1184,1291,854,724,130,148
"2011","Copeland","E07000029","Urban city and town in a sparse setting",0,0,0,0,0,0,0,0,0,0,0,0
"2011","Copeland","E07000029","Rural (total)",19599,14272,7776,6496,35,3193,988,2205,1811,1591,220,288
"2011","Copeland","E07000029","Rural town and fringe",12078,8058,4141,3917,16,2754,887,1867,1100,976,124,150
"2011","Copeland","E07000029","Rural town and fringe in a sparse setting",518,444,243,201,0,11,4,7,54,49,5,9
"2011","Copeland","E07000029","Rural village",3159,2642,1415,1227,7,218,66,152,251,223,28,41
"2011","Copeland","E07000029","Rural village in a sparse setting",1401,1190,777,413,4,79,14,65,108,95,13,20
"2011","Copeland","E07000029","Rural hamlet and isolated dwellings",1221,1025,584,441,3,60,7,53,106,85,21,27
"2011","Copeland","E07000029","Rural hamlet and isolated dwellings in a sparse setting",1222,913,616,297,5,71,10,61,192,163,29,41
"2011","Eden","E07000030","Total",23043,16258,10048,6210,211,2321,307,2014,3685,3216,469,568
"2011","Eden","E07000030","Urban (total)",6900,4628,2579,2049,92,1092,161,931,987,860,127,101
"2011","Eden","E07000030","Urban major conurbation",0,0,0,0,0,0,0,0,0,0,0,0
"2011","Eden","E07000030","Urban minor conurbation",0,0,0,0,0,0,0,0,0,0,0,0
"2011","Eden","E07000030","Urban city and town",264,216,148,68,0,15,6,9,30,21,9,3
"2011","Eden","E07000030","Urban city and town in a sparse setting",6636,4412,2431,1981,92,1077,155,922,957,839,118,98
"2011","Eden","E07000030","Rural (total)",16143,11630,7469,4161,119,1229,146,1083,2698,2356,342,467
"2011","Eden","E07000030","Rural town and fringe",0,0,0,0,0,0,0,0,0,0,0,0
"2011","Eden","E07000030","Rural town and fringe in a sparse setting",2427,1517,968,549,55,358,40,318,456,404,52,41
"2011","Eden","E07000030","Rural village",657,512,320,192,2,33,8,25,90,83,7,20
"2011","Eden","E07000030","Rural village in a sparse setting",9352,6881,4407,2474,53,758,86,672,1416,1205,211,244
"2011","Eden","E07000030","Rural hamlet and isolated dwellings",781,573,360,213,3,13,2,11,158,147,11,34
"2011","Eden","E07000030","Rural hamlet and isolated dwellings in a sparse setting",2926,2147,1414,733,6,67,10,57,578,517,61,128
"2011","South Lakeland","E07000031","Total",46552,33967,20793,13174,231,4853,3172,1681,6633,5831,802,868
"2011","South Lakeland","E07000031","Urban (total)",18381,13351,7328,6023,89,2209,1577,632,2480,2238,242,252
"2011","South Lakeland","E07000031","Urban major conurbation",0,0,0,0,0,0,0,0,0,0,0,0
"2011","South Lakeland","E07000031","Urban minor conurbation",0,0,0,0,0,0,0,0,0,0,0,0
"2011","South Lakeland","E07000031","Urban city and town",18381,13351,7328,6023,89,2209,1577,632,2480,2238,242,252
"2011","South Lakeland","E07000031","Urban city and town in a sparse setting",0,0,0,0,0,0,0,0,0,0,0,0
"2011","South Lakeland","E07000031","Rural (total)",28171,20616,13465,7151,142,2644,1595,1049,4153,3593,560,616
"2011","South Lakeland","E07000031","Rural town and fringe",6731,5303,3382,1921,41,584,387,197,705,610,95,98
"2011","South Lakeland","E07000031","Rural town and fringe in a sparse setting",5839,3495,2232,1263,38,1035,661,374,1135,1010,125,136
"2011","South Lakeland","E07000031","Rural village",6619,5335,3461,1874,13,386,246,140,756,669,87,129
"2011","South Lakeland","E07000031","Rural village in a sparse setting",1828,1131,822,309,14,303,113,190,311,251,60,69
"2011","South Lakeland","E07000031","Rural hamlet and isolated dwellings",4899,3806,2464,1342,18,192,142,50,781,669,112,102
"2011","South Lakeland","E07000031","Rural hamlet and isolated dwellings in a sparse setting",2255,1546,1104,442,18,144,46,98,465,384,81,82
"2011","Bolton","E08000001","Total",116371,74170,35378,38792,605,23825,16575,7250,15930,14555,1375,1841
"2011","Bolton","E08000001","Urban (total)",115280,73241,34872,38369,601,23800,16556,7244,15804,14442,1362,1834
"2011","Bolton","E08000001","Urban major conurbation",103309,64384,30621,33763,547,22259,15547,6712,14410,13181,1229,1709
"2011","Bolton","E08000001","Urban minor conurbation",0,0,0,0,0,0,0,0,0,0,0,0
"2011","Bolton","E08000001","Urban city and town",11971,8857,4251,4606,54,1541,1009,532,1394,1261,133,125
"2011","Bolton","E08000001","Urban city and town in a sparse setting",0,0,0,0,0,0,0,0,0,0,0,0
"2011","Bolton","E08000001","Rural (total)",1091,929,506,423,4,25,19,6,126,113,13,7
"2011","Bolton","E08000001","Rural town and fringe",218,196,100,96,0,3,1,2,19,17,2,0
"2011","Bolton","E08000001","Rural town and fringe in a sparse setting",0,0,0,0,0,0,0,0,0,0,0,0
"2011","Bolton","E08000001","Rural village",213,188,111,77,0,8,8,0,15,14,1,2
"2011","Bolton","E08000001","Rural village in a sparse setting",0,0,0,0,0,0,0,0,0,0,0,0
"2011","Bolton","E08000001","Rural hamlet and isolated dwellings",660,545,295,250,4,14,10,4,92,82,10,5
"2011","Bolton","E08000001","Rural hamlet and isolated dwellings in a sparse setting",0,0,0,0,0,0,0,0,0,0,0,0
"2011","Bury","E08000002","Total",78113,54395,24839,29556,247,11703,7314,4389,10774,9859,915,994
"2011","Bury","E08000002","Urban (total)",76061,52646,24004,28642,242,11640,7274,4366,10563,9673,890,970
"2011","Bury","E08000002","Urban major conurbation",75716,52386,23866,28520,242,11593,7228,4365,10529,9642,887,966
"2011","Bury","E08000002","Urban minor conurbation",0,0,0,0,0,0,0,0,0,0,0,0
"2011","Bury","E08000002","Urban city and town",345,260,138,122,0,47,46,1,34,31,3,4
"2011","Bury","E08000002","Urban city and town in a sparse setting",0,0,0,0,0,0,0,0,0,0,0,0
"2011","Bury","E08000002","Rural (total)",2052,1749,835,914,5,63,40,23,211,186,25,24
"2011","Bury","E08000002","Rural town and fringe",923,767,314,453,2,34,16,18,108,97,11,12
"2011","Bury","E08000002","Rural town and fringe in a sparse setting",0,0,0,0,0,0,0,0,0,0,0,0
"2011","Bury","E08000002","Rural village",841,716,384,332,3,28,24,4,83,71,12,11
"2011","Bury","E08000002","Rural village in a sparse setting",0,0,0,0,0,0,0,0,0,0,0,0
"2011","Bury","E08000002","Rural hamlet and isolated dwellings",288,266,137,129,0,1,0,1,20,18,2,1
"2011","Bury","E08000002","Rural hamlet and isolated dwellings in a sparse setting",0,0,0,0,0,0,0,0,0,0,0,0
"2011","Manchester","E08000003","Total",204969,77395,31145,46250,1481,64682,27585,37097,58170,55043,3127,3241
"2011","Manchester","E08000003","Urban (total)",204927,77377,31134,46243,1481,64678,27581,37097,58157,55031,3126,3234
"2011","Manchester","E08000003","Urban major conurbation",204927,77377,31134,46243,1481,64678,27581,37097,58157,55031,3126,3234
"2011","Manchester","E08000003","Urban minor conurbation",0,0,0,0,0,0,0,0,0,0,0,0
"2011","Manchester","E08000003","Urban city and town",0,0,0,0,0,0,0,0,0,0,0,0
"2011","Manchester","E08000003","Urban city and town in a sparse setting",0,0,0,0,0,0,0,0,0,0,0,0
"2011","Manchester","E08000003","Rural (total)",42,18,11,7,0,4,4,0,13,12,1,7
"2011","Manchester","E08000003","Rural town and fringe",0,0,0,0,0,0,0,0,0,0,0,0
"2011","Manchester","E08000003","Rural town and fringe in a sparse setting",0,0,0,0,0,0,0,0,0,0,0,0
"2011","Manchester","E08000003","Rural village",0,0,0,0,0,0,0,0,0,0,0,0
"2011","Manchester","E08000003","Rural village in a sparse setting",0,0,0,0,0,0,0,0,0,0,0,0
"2011","Manchester","E08000003","Rural hamlet and isolated dwellings",42,18,11,7,0,4,4,0,13,12,1,7
"2011","Manchester","E08000003","Rural hamlet and isolated dwellings in a sparse setting",0,0,0,0,0,0,0,0,0,0,0,0
"2011","Oldham","E08000004","Total",89703,58259,27193,31066,352,18918,8708,10210,10944,9676,1268,1230
"2011","Oldham","E08000004","Urban (total)",88628,57339,26724,30615,351,18887,8697,10190,10833,9580,1253,1218
"2011","Oldham","E08000004","Urban major conurbation",85521,54795,25365,29430,325,18721,8616,10105,10493,9284,1209,1187
"2011","Oldham","E08000004","Urban minor conurbation",0,0,0,0,0,0,0,0,0,0,0,0
"2011","Oldham","E08000004","Urban city and town",3107,2544,1359,1185,26,166,81,85,340,296,44,31
"2011","Oldham","E08000004","Urban city and town in a sparse setting",0,0,0,0,0,0,0,0,0,0,0,0
"2011","Oldham","E08000004","Rural (total)",1075,920,469,451,1,31,11,20,111,96,15,12
"2011","Oldham","E08000004","Rural town and fringe",141,118,62,56,0,4,0,4,19,15,4,0
"2011","Oldham","E08000004","Rural town and fringe in a sparse setting",0,0,0,0,0,0,0,0,0,0,0,0
"2011","Oldham","E08000004","Rural village",129,105,45,60,0,6,1,5,16,15,1,2
"2011","Oldham","E08000004","Rural village in a sparse setting",0,0,0,0,0,0,0,0,0,0,0,0
"2011","Oldham","E08000004","Rural hamlet and isolated dwellings",805,697,362,335,1,21,10,11,76,66,10,10
"2011","Oldham","E08000004","Rural hamlet and isolated dwellings in a sparse setting",0,0,0,0,0,0,0,0,0,0,0,0
"2011","Rochdale","E08000005","Total",87552,54149,24334,29815,340,20247,13671,6576,11556,10511,1045,1260
"2011","Rochdale","E08000005","Urban (total)",86457,53225,23815,29410,339,20231,13662,6569,11426,10403,1023,1236
"2011","Rochdale","E08000005","Urban major conurbation",85143,52170,23390,28780,338,20120,13560,6560,11296,10283,1013,1219
"2011","Rochdale","E08000005","Urban minor conurbation",0,0,0,0,0,0,0,0,0,0,0,0
"2011","Rochdale","E08000005","Urban city and town",1314,1055,425,630,1,111,102,9,130,120,10,17
"2011","Rochdale","E08000005","Urban city and town in a sparse setting",0,0,0,0,0,0,0,0,0,0,0,0
"2011","Rochdale","E08000005","Rural (total)",1095,924,519,405,1,16,9,7,130,108,22,24
"2011","Rochdale","E08000005","Rural town and fringe",213,189,117,72,0,6,3,3,17,14,3,1
"2011","Rochdale","E08000005","Rural town and fringe in a sparse setting",0,0,0,0,0,0,0,0,0,0,0,0
"2011","Rochdale","E08000005","Rural village",245,197,116,81,0,1,1,0,41,35,6,6
"2011","Rochdale","E08000005","Rural village in a sparse setting",0,0,0,0,0,0,0,0,0,0,0,0
"2011","Rochdale","E08000005","Rural hamlet and isolated dwellings",637,538,286,252,1,9,5,4,72,59,13,17
"2011","Rochdale","E08000005","Rural hamlet and isolated dwellings in a sparse setting",0,0,0,0,0,0,0,0,0,0,0,0
"2011","Salford","E08000006","Total",103556,52126,22603,29523,508,29819,18461,11358,19420,18224,1196,1683
"2011","Salford","E08000006","Urban (total)",103441,52022,22542,29480,508,29818,18461,11357,19413,18217,1196,1680
"2011","Salford","E08000006","Urban major conurbation",103441,52022,22542,29480,508,29818,18461,11357,19413,18217,1196,1680
"2011","Salford","E08000006","Urban minor conurbation",0,0,0,0,0,0,0,0,0,0,0,0
"2011","Salford","E08000006","Urban city and town",0,0,0,0,0,0,0,0,0,0,0,0
"2011","Salford","E08000006","Urban city and town in a sparse setting",0,0,0,0,0,0,0,0,0,0,0,0
"2011","Salford","E08000006","Rural (total)",115,104,61,43,0,1,0,1,7,7,0,3
"2011","Salford","E08000006","Rural town and fringe",0,0,0,0,0,0,0,0,0,0,0,0
"2011","Salford","E08000006","Rural town and fringe in a sparse setting",0,0,0,0,0,0,0,0,0,0,0,0
"2011","Salford","E08000006","Rural village",0,0,0,0,0,0,0,0,0,0,0,0
"2011","Salford","E08000006","Rural village in a sparse setting",0,0,0,0,0,0,0,0,0,0,0,0
"2011","Salford","E08000006","Rural hamlet and isolated dwellings",115,104,61,43,0,1,0,1,7,7,0,3
"2011","Salford","E08000006","Rural hamlet and isolated dwellings in a sparse setting",0,0,0,0,0,0,0,0,0,0,0,0
"2011","Stockport","E08000007","Total",121979,89316,42761,46555,987,16620,10577,6043,13852,12631,1221,1204
"2011","Stockport","E08000007","Urban (total)",121448,88850,42486,46364,984,16618,10577,6041,13800,12586,1214,1196
"2011","Stockport","E08000007","Urban major conurbation",118229,85940,40766,45174,978,16527,10501,6026,13625,12435,1190,1159
"2011","Stockport","E08000007","Urban minor conurbation",0,0,0,0,0,0,0,0,0,0,0,0
"2011","Stockport","E08000007","Urban city and town",3219,2910,1720,1190,6,91,76,15,175,151,24,37
"2011","Stockport","E08000007","Urban city and town in a sparse setting",0,0,0,0,0,0,0,0,0,0,0,0
"2011","Stockport","E08000007","Rural (total)",531,466,275,191,3,2,0,2,52,45,7,8
"2011","Stockport","E08000007","Rural town and fringe",0,0,0,0,0,0,0,0,0,0,0,0
"2011","Stockport","E08000007","Rural town and fringe in a sparse setting",0,0,0,0,0,0,0,0,0,0,0,0
"2011","Stockport","E08000007","Rural village",0,0,0,0,0,0,0,0,0,0,0,0
"2011","Stockport","E08000007","Rural village in a sparse setting",0,0,0,0,0,0,0,0,0,0,0,0
"2011","Stockport","E08000007","Rural hamlet and isolated dwellings",531,466,275,191,3,2,0,2,52,45,7,8
"2011","Stockport","E08000007","Rural hamlet and isolated dwellings in a sparse setting",0,0,0,0,0,0,0,0,0,0,0,0
"2011","Tameside","E08000008","Total",94953,60558,26688,33870,309,20438,4953,15485,12573,11345,1228,1075
"2011","Tameside","E08000008","Urban (total)",94698,60340,26583,33757,308,20435,4953,15482,12545,11320,1225,1070
"2011","Tameside","E08000008","Urban major conurbation",93848,59597,26218,33379,308,20400,4941,15459,12477,11259,1218,1066
"2011","Tameside","E08000008","Urban minor conurbation",0,0,0,0,0,0,0,0,0,0,0,0
"2011","Tameside","E08000008","Urban city and town",850,743,365,378,0,35,12,23,68,61,7,4
"2011","Tameside","E08000008","Urban city and town in a sparse setting",0,0,0,0,0,0,0,0,0,0,0,0
"2011","Tameside","E08000008","Rural (total)",255,218,105,113,1,3,0,3,28,25,3,5
"2011","Tameside","E08000008","Rural town and fringe",0,0,0,0,0,0,0,0,0,0,0,0
"2011","Tameside","E08000008","Rural town and fringe in a sparse setting",0,0,0,0,0,0,0,0,0,0,0,0
"2011","Tameside","E08000008","Rural village",0,0,0,0,0,0,0,0,0,0,0,0
"2011","Tameside","E08000008","Rural village in a sparse setting",0,0,0,0,0,0,0,0,0,0,0,0
"2011","Tameside","E08000008","Rural hamlet and isolated dwellings",255,218,105,113,1,3,0,3,28,25,3,5
"2011","Tameside","E08000008","Rural hamlet and isolated dwellings in a sparse setting",0,0,0,0,0,0,0,0,0,0,0,0
"2011","Trafford","E08000009","Total",94484,65440,30322,35118,570,15485,4373,11112,12001,11173,828,988
"2011","Trafford","E08000009","Urban (total)",94143,65248,30208,35040,567,15416,4359,11057,11941,11130,811,971
"2011","Trafford","E08000009","Urban major conurbation",92458,63780,29426,34354,562,15371,4344,11027,11790,10997,793,955
"2011","Trafford","E08000009","Urban minor conurbation",0,0,0,0,0,0,0,0,0,0,0,0
"2011","Trafford","E08000009","Urban city and town",1685,1468,782,686,5,45,15,30,151,133,18,16
"2011","Trafford","E08000009","Urban city and town in a sparse setting",0,0,0,0,0,0,0,0,0,0,0,0
"2011","Trafford","E08000009","Rural (total)",341,192,114,78,3,69,14,55,60,43,17,17
"2011","Trafford","E08000009","Rural town and fringe",0,0,0,0,0,0,0,0,0,0,0,0
"2011","Trafford","E08000009","Rural town and fringe in a sparse setting",0,0,0,0,0,0,0,0,0,0,0,0
"2011","Trafford","E08000009","Rural village",250,139,84,55,2,51,13,38,44,33,11,14
"2011","Trafford","E08000009","Rural village in a sparse setting",0,0,0,0,0,0,0,0,0,0,0,0
"2011","Trafford","E08000009","Rural hamlet and isolated dwellings",91,53,30,23,1,18,1,17,16,10,6,3
"2011","Trafford","E08000009","Rural hamlet and isolated dwellings in a sparse setting",0,0,0,0,0,0,0,0,0,0,0,0
"2011","Wigan","E08000010","Total",136386,92559,42446,50113,331,25803,22152,3651,15875,14550,1325,1818
"2011","Wigan","E08000010","Urban (total)",131352,89566,40957,48609,321,24293,20777,3516,15440,14174,1266,1732
"2011","Wigan","E08000010","Urban major conurbation",128993,87531,39930,47601,320,24209,20704,3505,15218,13968,1250,1715
"2011","Wigan","E08000010","Urban minor conurbation",0,0,0,0,0,0,0,0,0,0,0,0
"2011","Wigan","E08000010","Urban city and town",2359,2035,1027,1008,1,84,73,11,222,206,16,17
"2011","Wigan","E08000010","Urban city and town in a sparse setting",0,0,0,0,0,0,0,0,0,0,0,0
"2011","Wigan","E08000010","Rural (total)",5034,2993,1489,1504,10,1510,1375,135,435,376,59,86
"2011","Wigan","E08000010","Rural town and fringe",3589,1911,965,946,9,1361,1272,89,236,209,27,72
"2011","Wigan","E08000010","Rural town and fringe in a sparse setting",0,0,0,0,0,0,0,0,0,0,0,0
"2011","Wigan","E08000010","Rural village",938,679,357,322,1,100,94,6,152,126,26,6
"2011","Wigan","E08000010","Rural village in a sparse setting",0,0,0,0,0,0,0,0,0,0,0,0
"2011","Wigan","E08000010","Rural hamlet and isolated dwellings",507,403,167,236,0,49,9,40,47,41,6,8
"2011","Wigan","E08000010","Rural hamlet and isolated dwellings in a sparse setting",0,0,0,0,0,0,0,0,0,0,0,0
"2011","Burnley","E07000117","Total",37550,24408,11815,12593,79,5281,1418,3863,7267,6664,603,515
"2011","Burnley","E07000117","Urban (total)",35606,22772,10988,11784,74,5232,1401,3831,7034,6452,582,494
"2011","Burnley","E07000117","Urban major conurbation",0,0,0,0,0,0,0,0,0,0,0,0
"2011","Burnley","E07000117","Urban minor conurbation",0,0,0,0,0,0,0,0,0,0,0,0
"2011","Burnley","E07000117","Urban city and town",35606,22772,10988,11784,74,5232,1401,3831,7034,6452,582,494
"2011","Burnley","E07000117","Urban city and town in a sparse setting",0,0,0,0,0,0,0,0,0,0,0,0
"2011","Burnley","E07000117","Rural (total)",1944,1636,827,809,5,49,17,32,233,212,21,21
"2011","Burnley","E07000117","Rural town and fringe",727,576,237,339,2,28,6,22,119,111,8,2
"2011","Burnley","E07000117","Rural town and fringe in a sparse setting",0,0,0,0,0,0,0,0,0,0,0,0
"2011","Burnley","E07000117","Rural village",710,642,381,261,1,18,11,7,42,39,3,7
"2011","Burnley","E07000117","Rural village in a sparse setting",0,0,0,0,0,0,0,0,0,0,0,0
"2011","Burnley","E07000117","Rural hamlet and isolated dwellings",507,418,209,209,2,3,0,3,72,62,10,12
"2011","Burnley","E07000117","Rural hamlet and isolated dwellings in a sparse setting",0,0,0,0,0,0,0,0,0,0,0,0
"2011","Chorley","E07000118","Total",44919,33783,15906,17877,283,5843,1376,4467,4587,4066,521,423
"2011","Chorley","E07000118","Urban (total)",31920,23035,10320,12715,183,4939,1060,3879,3466,3084,382,297
"2011","Chorley","E07000118","Urban major conurbation",0,0,0,0,0,0,0,0,0,0,0,0
"2011","Chorley","E07000118","Urban minor conurbation",0,0,0,0,0,0,0,0,0,0,0,0
"2011","Chorley","E07000118","Urban city and town",31920,23035,10320,12715,183,4939,1060,3879,3466,3084,382,297
"2011","Chorley","E07000118","Urban city and town in a sparse setting",0,0,0,0,0,0,0,0,0,0,0,0
"2011","Chorley","E07000118","Rural (total)",12999,10748,5586,5162,100,904,316,588,1121,982,139,126
"2011","Chorley","E07000118","Rural town and fringe",7747,6268,3116,3152,74,668,273,395,669,588,81,68
"2011","Chorley","E07000118","Rural town and fringe in a sparse setting",0,0,0,0,0,0,0,0,0,0,0,0
"2011","Chorley","E07000118","Rural village",2802,2355,1213,1142,16,175,27,148,232,196,36,24
"2011","Chorley","E07000118","Rural village in a sparse setting",0,0,0,0,0,0,0,0,0,0,0,0
"2011","Chorley","E07000118","Rural hamlet and isolated dwellings",2450,2125,1257,868,10,61,16,45,220,198,22,34
"2011","Chorley","E07000118","Rural hamlet and isolated dwellings in a sparse setting",0,0,0,0,0,0,0,0,0,0,0,0
"2011","Fylde","E07000119","Total",34885,25622,14214,11408,135,2607,499,2108,6066,5411,655,455
"2011","Fylde","E07000119","Urban (total)",27555,19758,10992,8766,114,2112,374,1738,5214,4774,440,357
"2011","Fylde","E07000119","Urban major conurbation",0,0,0,0,0,0,0,0,0,0,0,0
"2011","Fylde","E07000119","Urban minor conurbation",0,0,0,0,0,0,0,0,0,0,0,0
"2011","Fylde","E07000119","Urban city and town",27555,19758,10992,8766,114,2112,374,1738,5214,4774,440,357
"2011","Fylde","E07000119","Urban city and town in a sparse setting",0,0,0,0,0,0,0,0,0,0,0,0
"2011","Fylde","E07000119","Rural (total)",7330,5864,3222,2642,21,495,125,370,852,637,215,98
"2011","Fylde","E07000119","Rural town and fringe",4773,3918,2134,1784,13,298,68,230,487,401,86,57
"2011","Fylde","E07000119","Rural town and fringe in a sparse setting",0,0,0,0,0,0,0,0,0,0,0,0
"2011","Fylde","E07000119","Rural village",1949,1443,784,659,4,173,47,126,301,184,117,28
"2011","Fylde","E07000119","Rural village in a sparse setting",0,0,0,0,0,0,0,0,0,0,0,0
"2011","Fylde","E07000119","Rural hamlet and isolated dwellings",608,503,304,199,4,24,10,14,64,52,12,13
"2011","Fylde","E07000119","Rural hamlet and isolated dwellings in a sparse setting",0,0,0,0,0,0,0,0,0,0,0,0
"2011","Hyndburn","E07000120","Total",34341,23238,11464,11774,84,4389,1367,3022,6235,5711,524,395
"2011","Hyndburn","E07000120","Urban (total)",30972,20795,10251,10544,78,4163,1312,2851,5565,5087,478,371
"2011","Hyndburn","E07000120","Urban major conurbation",0,0,0,0,0,0,0,0,0,0,0,0
"2011","Hyndburn","E07000120","Urban minor conurbation",0,0,0,0,0,0,0,0,0,0,0,0
"2011","Hyndburn","E07000120","Urban city and town",30972,20795,10251,10544,78,4163,1312,2851,5565,5087,478,371
"2011","Hyndburn","E07000120","Urban city and town in a sparse setting",0,0,0,0,0,0,0,0,0,0,0,0
"2011","Hyndburn","E07000120","Rural (total)",3369,2443,1213,1230,6,226,55,171,670,624,46,24
"2011","Hyndburn","E07000120","Rural town and fringe",2912,2037,1016,1021,3,224,54,170,628,586,42,20
"2011","Hyndburn","E07000120","Rural town and fringe in a sparse setting",0,0,0,0,0,0,0,0,0,0,0,0
"2011","Hyndburn","E07000120","Rural village",306,276,135,141,0,2,1,1,26,24,2,2
"2011","Hyndburn","E07000120","Rural village in a sparse setting",0,0,0,0,0,0,0,0,0,0,0,0
"2011","Hyndburn","E07000120","Rural hamlet and isolated dwellings",151,130,62,68,3,0,0,0,16,14,2,2
"2011","Hyndburn","E07000120","Rural hamlet and isolated dwellings in a sparse setting",0,0,0,0,0,0,0,0,0,0,0,0
"2011","Lancaster","E07000121","Total",57822,39999,20890,19109,367,5762,3629,2133,10929,9915,1014,765
"2011","Lancaster","E07000121","Urban (total)",42489,27462,13529,13933,294,5045,3042,2003,9179,8407,772,509
"2011","Lancaster","E07000121","Urban major conurbation",0,0,0,0,0,0,0,0,0,0,0,0
"2011","Lancaster","E07000121","Urban minor conurbation",0,0,0,0,0,0,0,0,0,0,0,0
"2011","Lancaster","E07000121","Urban city and town",42489,27462,13529,13933,294,5045,3042,2003,9179,8407,772,509
"2011","Lancaster","E07000121","Urban city and town in a sparse setting",0,0,0,0,0,0,0,0,0,0,0,0
"2011","Lancaster","E07000121","Rural (total)",15333,12537,7361,5176,73,717,587,130,1750,1508,242,256
"2011","Lancaster","E07000121","Rural town and fringe",9354,7790,4430,3360,48,497,418,79,924,815,109,95
"2011","Lancaster","E07000121","Rural town and fringe in a sparse setting",0,0,0,0,0,0,0,0,0,0,0,0
"2011","Lancaster","E07000121","Rural village",3230,2651,1631,1020,13,139,98,41,366,306,60,61
"2011","Lancaster","E07000121","Rural village in a sparse setting",0,0,0,0,0,0,0,0,0,0,0,0
"2011","Lancaster","E07000121","Rural hamlet and isolated dwellings",2565,1964,1213,751,10,70,60,10,429,360,69,92
"2011","Lancaster","E07000121","Rural hamlet and isolated dwellings in a sparse setting",184,132,87,45,2,11,11,0,31,27,4,8
"2011","Pendle","E07000122","Total",37348,25580,13435,12145,73,4333,2104,2229,6760,6192,568,602
"2011","Pendle","E07000122","Urban (total)",31926,21280,11120,10160,62,4006,1940,2066,6056,5567,489,522
"2011","Pendle","E07000122","Urban major conurbation",0,0,0,0,0,0,0,0,0,0,0,0
"2011","Pendle","E07000122","Urban minor conurbation",0,0,0,0,0,0,0,0,0,0,0,0
"2011","Pendle","E07000122","Urban city and town",31926,21280,11120,10160,62,4006,1940,2066,6056,5567,489,522
"2011","Pendle","E07000122","Urban city and town in a sparse setting",0,0,0,0,0,0,0,0,0,0,0,0
"2011","Pendle","E07000122","Rural (total)",5422,4300,2315,1985,11,327,164,163,704,625,79,80
"2011","Pendle","E07000122","Rural town and fringe",2971,2213,1140,1073,6,280,143,137,430,386,44,42
"2011","Pendle","E07000122","Rural town and fringe in a sparse setting",0,0,0,0,0,0,0,0,0,0,0,0
"2011","Pendle","E07000122","Rural village",1212,1030,605,425,3,40,17,23,126,110,16,13
"2011","Pendle","E07000122","Rural village in a sparse setting",0,0,0,0,0,0,0,0,0,0,0,0
"2011","Pendle","E07000122","Rural hamlet and isolated dwellings",1239,1057,570,487,2,7,4,3,148,129,19,25
"2011","Pendle","E07000122","Rural hamlet and isolated dwellings in a sparse setting",0,0,0,0,0,0,0,0,0,0,0,0
"2011","Preston","E07000123","Total",57567,34909,16355,18554,397,11061,2259,8802,10365,9540,825,835
"2011","Preston","E07000123","Urban (total)",54343,32070,14697,17373,388,10976,2243,8733,10128,9353,775,781
"2011","Preston","E07000123","Urban major conurbation",0,0,0,0,0,0,0,0,0,0,0,0
"2011","Preston","E07000123","Urban minor conurbation",0,0,0,0,0,0,0,0,0,0,0,0
"2011","Preston","E07000123","Urban city and town",54343,32070,14697,17373,388,10976,2243,8733,10128,9353,775,781
"2011","Preston","E07000123","Urban city and town in a sparse setting",0,0,0,0,0,0,0,0,0,0,0,0
"2011","Preston","E07000123","Rural (total)",3224,2839,1658,1181,9,85,16,69,237,187,50,54
"2011","Preston","E07000123","Rural town and fringe",501,441,283,158,0,34,1,33,24,20,4,2
"2011","Preston","E07000123","Rural town and fringe in a sparse setting",0,0,0,0,0,0,0,0,0,0,0,0
"2011","Preston","E07000123","Rural village",1310,1173,669,504,4,15,6,9,95,80,15,23
"2011","Preston","E07000123","Rural village in a sparse setting",0,0,0,0,0,0,0,0,0,0,0,0
"2011","Preston","E07000123","Rural hamlet and isolated dwellings",1413,1225,706,519,5,36,9,27,118,87,31,29
"2011","Preston","E07000123","Rural hamlet and isolated dwellings in a sparse setting",0,0,0,0,0,0,0,0,0,0,0,0
"2011","Ribble Valley","E07000124","Total",24045,18423,10086,8337,145,1836,365,1471,3278,2830,448,363
"2011","Ribble Valley","E07000124","Urban (total)",8226,6038,3252,2786,39,974,209,765,1040,915,125,135
"2011","Ribble Valley","E07000124","Urban major conurbation",0,0,0,0,0,0,0,0,0,0,0,0
"2011","Ribble Valley","E07000124","Urban minor conurbation",0,0,0,0,0,0,0,0,0,0,0,0
"2011","Ribble Valley","E07000124","Urban city and town",8226,6038,3252,2786,39,974,209,765,1040,915,125,135
"2011","Ribble Valley","E07000124","Urban city and town in a sparse setting",0,0,0,0,0,0,0,0,0,0,0,0
"2011","Ribble Valley","E07000124","Rural (total)",15819,12385,6834,5551,106,862,156,706,2238,1915,323,228
"2011","Ribble Valley","E07000124","Rural town and fringe",8287,6601,3658,2943,74,554,115,439,978,843,135,80
"2011","Ribble Valley","E07000124","Rural town and fringe in a sparse setting",0,0,0,0,0,0,0,0,0,0,0,0
"2011","Ribble Valley","E07000124","Rural village",4025,3188,1684,1504,21,260,29,231,499,431,68,57
"2011","Ribble Valley","E07000124","Rural village in a sparse setting",0,0,0,0,0,0,0,0,0,0,0,0
"2011","Ribble Valley","E07000124","Rural hamlet and isolated dwellings",3507,2596,1492,1104,11,48,12,36,761,641,120,91
"2011","Ribble Valley","E07000124","Rural hamlet and isolated dwellings in a sparse setting",0,0,0,0,0,0,0,0,0,0,0,0
"2011","Rossendale","E07000125","Total",29058,20250,9160,11090,87,4244,1416,2828,4106,3683,423,371
"2011","Rossendale","E07000125","Urban (total)",27613,19051,8696,10355,86,4212,1408,2804,3907,3500,407,357
"2011","Rossendale","E07000125","Urban major conurbation",661,529,231,298,1,32,8,24,96,85,11,3
"2011","Rossendale","E07000125","Urban minor conurbation",0,0,0,0,0,0,0,0,0,0,0,0
"2011","Rossendale","E07000125","Urban city and town",26952,18522,8465,10057,85,4180,1400,2780,3811,3415,396,354
"2011","Rossendale","E07000125","Urban city and town in a sparse setting",0,0,0,0,0,0,0,0,0,0,0,0
"2011","Rossendale","E07000125","Rural (total)",1445,1199,464,735,1,32,8,24,199,183,16,14
"2011","Rossendale","E07000125","Rural town and fringe",690,583,208,375,0,20,5,15,82,71,11,5
"2011","Rossendale","E07000125","Rural town and fringe in a sparse setting",0,0,0,0,0,0,0,0,0,0,0,0
"2011","Rossendale","E07000125","Rural village",0,0,0,0,0,0,0,0,0,0,0,0
"2011","Rossendale","E07000125","Rural village in a sparse setting",0,0,0,0,0,0,0,0,0,0,0,0
"2011","Rossendale","E07000125","Rural hamlet and isolated dwellings",755,616,256,360,1,12,3,9,117,112,5,9
"2011","Rossendale","E07000125","Rural hamlet and isolated dwellings in a sparse setting",0,0,0,0,0,0,0,0,0,0,0,0
"2011","South Ribble","E07000126","Total",46102,36337,17189,19148,215,4845,353,4492,4308,3845,463,397
"2011","South Ribble","E07000126","Urban (total)",45374,35708,16833,18875,214,4826,348,4478,4245,3791,454,381
"2011","South Ribble","E07000126","Urban major conurbation",0,0,0,0,0,0,0,0,0,0,0,0
"2011","South Ribble","E07000126","Urban minor conurbation",0,0,0,0,0,0,0,0,0,0,0,0
"2011","South Ribble","E07000126","Urban city and town",45374,35708,16833,18875,214,4826,348,4478,4245,3791,454,381
"2011","South Ribble","E07000126","Urban city and town in a sparse setting",0,0,0,0,0,0,0,0,0,0,0,0
"2011","South Ribble","E07000126","Rural (total)",728,629,356,273,1,19,5,14,63,54,9,16
"2011","South Ribble","E07000126","Rural town and fringe",0,0,0,0,0,0,0,0,0,0,0,0
"2011","South Ribble","E07000126","Rural town and fringe in a sparse setting",0,0,0,0,0,0,0,0,0,0,0,0
"2011","South Ribble","E07000126","Rural village",297,260,163,97,0,5,1,4,23,22,1,9
"2011","South Ribble","E07000126","Rural village in a sparse setting",0,0,0,0,0,0,0,0,0,0,0,0
"2011","South Ribble","E07000126","Rural hamlet and isolated dwellings",431,369,193,176,1,14,4,10,40,32,8,7
"2011","South Ribble","E07000126","Rural hamlet and isolated dwellings in a sparse setting",0,0,0,0,0,0,0,0,0,0,0,0
"2011","West Lancashire","E07000127","Total",45381,33122,16272,16850,271,6656,5711,945,4744,4263,481,588
"2011","West Lancashire","E07000127","Urban (total)",27780,18722,8626,10096,156,5422,4792,630,3131,2869,262,349
"2011","West Lancashire","E07000127","Urban major conurbation",16523,9942,3798,6144,41,4533,4113,420,1788,1633,155,219
"2011","West Lancashire","E07000127","Urban minor conurbation",0,0,0,0,0,0,0,0,0,0,0,0
"2011","West Lancashire","E07000127","Urban city and town",11257,8780,4828,3952,115,889,679,210,1343,1236,107,130
"2011","West Lancashire","E07000127","Urban city and town in a sparse setting",0,0,0,0,0,0,0,0,0,0,0,0
"2011","West Lancashire","E07000127","Rural (total)",17601,14400,7646,6754,115,1234,919,315,1613,1394,219,239
"2011","West Lancashire","E07000127","Rural town and fringe",9573,7646,3762,3884,66,820,589,231,927,823,104,114
"2011","West Lancashire","E07000127","Rural town and fringe in a sparse setting",0,0,0,0,0,0,0,0,0,0,0,0
"2011","West Lancashire","E07000127","Rural village",4051,3350,1862,1488,42,299,237,62,300,248,52,60
"2011","West Lancashire","E07000127","Rural village in a sparse setting",0,0,0,0,0,0,0,0,0,0,0,0
"2011","West Lancashire","E07000127","Rural hamlet and isolated dwellings",3977,3404,2022,1382,7,115,93,22,386,323,63,65
"2011","West Lancashire","E07000127","Rural hamlet and isolated dwellings in a sparse setting",0,0,0,0,0,0,0,0,0,0,0,0
"2011","Wyre","E07000128","Total",47281,36676,20423,16253,246,3401,522,2879,6397,5791,606,561
"2011","Wyre","E07000128","Urban (total)",34048,25870,13863,12007,125,2760,469,2291,4926,4516,410,367
"2011","Wyre","E07000128","Urban major conurbation",0,0,0,0,0,0,0,0,0,0,0,0
"2011","Wyre","E07000128","Urban minor conurbation",0,0,0,0,0,0,0,0,0,0,0,0
"2011","Wyre","E07000128","Urban city and town",34048,25870,13863,12007,125,2760,469,2291,4926,4516,410,367
"2011","Wyre","E07000128","Urban city and town in a sparse setting",0,0,0,0,0,0,0,0,0,0,0,0
"2011","Wyre","E07000128","Rural (total)",13233,10806,6560,4246,121,641,53,588,1471,1275,196,194
"2011","Wyre","E07000128","Rural town and fringe",8032,6500,3989,2511,96,436,36,400,901,792,109,99
"2011","Wyre","E07000128","Rural town and fringe in a sparse setting",0,0,0,0,0,0,0,0,0,0,0,0
"2011","Wyre","E07000128","Rural village",2698,2247,1352,895,20,168,12,156,220,180,40,43
"2011","Wyre","E07000128","Rural village in a sparse setting",0,0,0,0,0,0,0,0,0,0,0,0
"2011","Wyre","E07000128","Rural hamlet and isolated dwellings",2503,2059,1219,840,5,37,5,32,350,303,47,52
"2011","Wyre","E07000128","Rural hamlet and isolated dwellings in a sparse setting",0,0,0,0,0,0,0,0,0,0,0,0
"2011","Knowsley","E08000011","Total",61323,37896,16032,21864,314,16333,7479,8854,5980,5488,492,800
"2011","Knowsley","E08000011","Urban (total)",60884,37593,15819,21774,312,16227,7418,8809,5964,5475,489,788
"2011","Knowsley","E08000011","Urban major conurbation",59042,36205,15055,21150,308,16005,7314,8691,5785,5315,470,739
"2011","Knowsley","E08000011","Urban minor conurbation",0,0,0,0,0,0,0,0,0,0,0,0
"2011","Knowsley","E08000011","Urban city and town",1842,1388,764,624,4,222,104,118,179,160,19,49
"2011","Knowsley","E08000011","Urban city and town in a sparse setting",0,0,0,0,0,0,0,0,0,0,0,0
"2011","Knowsley","E08000011","Rural (total)",439,303,213,90,2,106,61,45,16,13,3,12
"2011","Knowsley","E08000011","Rural town and fringe",109,17,5,12,1,88,57,31,1,1,0,2
"2011","Knowsley","E08000011","Rural town and fringe in a sparse setting",0,0,0,0,0,0,0,0,0,0,0,0
"2011","Knowsley","E08000011","Rural village",0,0,0,0,0,0,0,0,0,0,0,0
"2011","Knowsley","E08000011","Rural village in a sparse setting",0,0,0,0,0,0,0,0,0,0,0,0
"2011","Knowsley","E08000011","Rural hamlet and isolated dwellings",330,286,208,78,1,18,4,14,15,12,3,10
"2011","Knowsley","E08000011","Rural hamlet and isolated dwellings in a sparse setting",0,0,0,0,0,0,0,0,0,0,0,0
"2011","Liverpool","E08000012","Total",206515,96947,43803,53144,1096,57485,9868,47617,48290,44912,3378,2697
"2011","Liverpool","E08000012","Urban (total)",206515,96947,43803,53144,1096,57485,9868,47617,48290,44912,3378,2697
"2011","Liverpool","E08000012","Urban major conurbation",206515,96947,43803,53144,1096,57485,9868,47617,48290,44912,3378,2697
"2011","Liverpool","E08000012","Urban minor conurbation",0,0,0,0,0,0,0,0,0,0,0,0
"2011","Liverpool","E08000012","Urban city and town",0,0,0,0,0,0,0,0,0,0,0,0
"2011","Liverpool","E08000012","Urban city and town in a sparse setting",0,0,0,0,0,0,0,0,0,0,0,0
"2011","Liverpool","E08000012","Rural (total)",0,0,0,0,0,0,0,0,0,0,0,0
"2011","Liverpool","E08000012","Rural town and fringe",0,0,0,0,0,0,0,0,0,0,0,0
"2011","Liverpool","E08000012","Rural town and fringe in a sparse setting",0,0,0,0,0,0,0,0,0,0,0,0
"2011","Liverpool","E08000012","Rural village",0,0,0,0,0,0,0,0,0,0,0,0
"2011","Liverpool","E08000012","Rural village in a sparse setting",0,0,0,0,0,0,0,0,0,0,0,0
"2011","Liverpool","E08000012","Rural hamlet and isolated dwellings",0,0,0,0,0,0,0,0,0,0,0,0
"2011","Liverpool","E08000012","Rural hamlet and isolated dwellings in a sparse setting",0,0,0,0,0,0,0,0,0,0,0,0
"2011","Sefton","E08000014","Total",117930,83137,42334,40803,664,17063,4911,12152,15804,14552,1252,1262
"2011","Sefton","E08000014","Urban (total)",116265,81717,41578,40139,663,17015,4882,12133,15624,14397,1227,1246
"2011","Sefton","E08000014","Urban major conurbation",66189,43669,20587,23082,338,13905,4406,9499,7546,6956,590,731
"2011","Sefton","E08000014","Urban minor conurbation",0,0,0,0,0,0,0,0,0,0,0,0
"2011","Sefton","E08000014","Urban city and town",50076,38048,20991,17057,325,3110,476,2634,8078,7441,637,515
"2011","Sefton","E08000014","Urban city and town in a sparse setting",0,0,0,0,0,0,0,0,0,0,0,0
"2011","Sefton","E08000014","Rural (total)",1665,1420,756,664,1,48,29,19,180,155,25,16
"2011","Sefton","E08000014","Rural town and fringe",892,824,450,374,0,13,9,4,47,38,9,8
"2011","Sefton","E08000014","Rural town and fringe in a sparse setting",0,0,0,0,0,0,0,0,0,0,0,0
"2011","Sefton","E08000014","Rural village",438,306,152,154,0,24,13,11,103,93,10,5
"2011","Sefton","E08000014","Rural village in a sparse setting",0,0,0,0,0,0,0,0,0,0,0,0
"2011","Sefton","E08000014","Rural hamlet and isolated dwellings",335,290,154,136,1,11,7,4,30,24,6,3
"2011","Sefton","E08000014","Rural hamlet and isolated dwellings in a sparse setting",0,0,0,0,0,0,0,0,0,0,0,0
"2011","St. Helens","E08000013","Total",75736,50952,25215,25737,427,15597,4590,11007,7736,7056,680,1024
"2011","St. Helens","E08000013","Urban (total)",71645,47510,23319,24191,417,15262,4512,10750,7483,6825,658,973
"2011","St. Helens","E08000013","Urban major conurbation",68521,44761,21639,23122,411,15107,4467,10640,7306,6676,630,936
"2011","St. Helens","E08000013","Urban minor conurbation",0,0,0,0,0,0,0,0,0,0,0,0
"2011","St. Helens","E08000013","Urban city and town",3124,2749,1680,1069,6,155,45,110,177,149,28,37
"2011","St. Helens","E08000013","Urban city and town in a sparse setting",0,0,0,0,0,0,0,0,0,0,0,0
"2011","St. Helens","E08000013","Rural (total)",4091,3442,1896,1546,10,335,78,257,253,231,22,51
"2011","St. Helens","E08000013","Rural town and fringe",3422,2891,1592,1299,6,300,69,231,183,167,16,42
"2011","St. Helens","E08000013","Rural town and fringe in a sparse setting",0,0,0,0,0,0,0,0,0,0,0,0
"2011","St. Helens","E08000013","Rural village",148,125,74,51,2,8,4,4,11,9,2,2
"2011","St. Helens","E08000013","Rural village in a sparse setting",0,0,0,0,0,0,0,0,0,0,0,0
"2011","St. Helens","E08000013","Rural hamlet and isolated dwellings",521,426,230,196,2,27,5,22,59,55,4,7
"2011","St. Helens","E08000013","Rural hamlet and isolated dwellings in a sparse setting",0,0,0,0,0,0,0,0,0,0,0,0
"2011","Wirral","E08000015","Total",140583,94843,46806,48037,713,21329,7266,14063,22275,20636,1639,1423
"2011","Wirral","E08000015","Urban (total)",138992,93616,46147,47469,710,21291,7249,14042,22005,20406,1599,1370
"2011","Wirral","E08000015","Urban major conurbation",137969,92637,45575,47062,709,21289,7248,14041,21971,20375,1596,1363
"2011","Wirral","E08000015","Urban minor conurbation",0,0,0,0,0,0,0,0,0,0,0,0
"2011","Wirral","E08000015","Urban city and town",1023,979,572,407,1,2,1,1,34,31,3,7
"2011","Wirral","E08000015","Urban city and town in a sparse setting",0,0,0,0,0,0,0,0,0,0,0,0
"2011","Wirral","E08000015","Rural (total)",1591,1227,659,568,3,38,17,21,270,230,40,53
"2011","Wirral","E08000015","Rural town and fringe",436,351,208,143,1,8,3,5,71,61,10,5
"2011","Wirral","E08000015","Rural town and fringe in a sparse setting",0,0,0,0,0,0,0,0,0,0,0,0
"2011","Wirral","E08000015","Rural village",451,331,193,138,0,11,2,9,80,71,9,29
"2011","Wirral","E08000015","Rural village in a sparse setting",0,0,0,0,0,0,0,0,0,0,0,0
"2011","Wirral","E08000015","Rural hamlet and isolated dwellings",704,545,258,287,2,19,12,7,119,98,21,19
"2011","Wirral","E08000015","Rural hamlet and isolated dwellings in a sparse setting",0,0,0,0,0,0,0,0,0,0,0,0
"2011","East Riding of Yorkshire","E06000011","Total",143032,107706,56140,51566,433,13028,10453,2575,19648,17760,1888,2217
"2011","East Riding of Yorkshire","E06000011","Urban (total)",81285,59861,30963,28898,248,8181,6549,1632,11989,11022,967,1006
"2011","East Riding of Yorkshire","E06000011","Urban major conurbation",0,0,0,0,0,0,0,0,0,0,0,0
"2011","East Riding of Yorkshire","E06000011","Urban minor conurbation",0,0,0,0,0,0,0,0,0,0,0,0
"2011","East Riding of Yorkshire","E06000011","Urban city and town",81285,59861,30963,28898,248,8181,6549,1632,11989,11022,967,1006
"2011","East Riding of Yorkshire","E06000011","Urban city and town in a sparse setting",0,0,0,0,0,0,0,0,0,0,0,0
"2011","East Riding of Yorkshire","E06000011","Rural (total)",61747,47845,25177,22668,185,4847,3904,943,7659,6738,921,1211
"2011","East Riding of Yorkshire","E06000011","Rural town and fringe",34944,27129,14044,13085,108,3001,2339,662,4208,3750,458,498
"2011","East Riding of Yorkshire","E06000011","Rural town and fringe in a sparse setting",0,0,0,0,0,0,0,0,0,0,0,0
"2011","East Riding of Yorkshire","E06000011","Rural village",20834,16235,8604,7631,63,1619,1390,229,2457,2123,334,460
"2011","East Riding of Yorkshire","E06000011","Rural village in a sparse setting",0,0,0,0,0,0,0,0,0,0,0,0
"2011","East Riding of Yorkshire","E06000011","Rural hamlet and isolated dwellings",5969,4481,2529,1952,14,227,175,52,994,865,129,253
"2011","East Riding of Yorkshire","E06000011","Rural hamlet and isolated dwellings in a sparse setting",0,0,0,0,0,0,0,0,0,0,0,0
"2011","Kingston upon Hull, City of","E06000010","Total",112596,55785,22355,33430,505,31634,23838,7796,22984,21414,1570,1688
"2011","Kingston upon Hull, City of","E06000010","Urban (total)",112596,55785,22355,33430,505,31634,23838,7796,22984,21414,1570,1688
"2011","Kingston upon Hull, City of","E06000010","Urban major conurbation",0,0,0,0,0,0,0,0,0,0,0,0
"2011","Kingston upon Hull, City of","E06000010","Urban minor conurbation",0,0,0,0,0,0,0,0,0,0,0,0
"2011","Kingston upon Hull, City of","E06000010","Urban city and town",112596,55785,22355,33430,505,31634,23838,7796,22984,21414,1570,1688
"2011","Kingston upon Hull, City of","E06000010","Urban city and town in a sparse setting",0,0,0,0,0,0,0,0,0,0,0,0
"2011","Kingston upon Hull, City of","E06000010","Rural (total)",0,0,0,0,0,0,0,0,0,0,0,0
"2011","Kingston upon Hull, City of","E06000010","Rural town and fringe",0,0,0,0,0,0,0,0,0,0,0,0
"2011","Kingston upon Hull, City of","E06000010","Rural town and fringe in a sparse setting",0,0,0,0,0,0,0,0,0,0,0,0
"2011","Kingston upon Hull, City of","E06000010","Rural village",0,0,0,0,0,0,0,0,0,0,0,0
"2011","Kingston upon Hull, City of","E06000010","Rural village in a sparse setting",0,0,0,0,0,0,0,0,0,0,0,0
"2011","Kingston upon Hull, City of","E06000010","Rural hamlet and isolated dwellings",0,0,0,0,0,0,0,0,0,0,0,0
"2011","Kingston upon Hull, City of","E06000010","Rural hamlet and isolated dwellings in a sparse setting",0,0,0,0,0,0,0,0,0,0,0,0
"2011","North East Lincolnshire","E06000012","Total",69707,46070,21497,24573,213,10091,3293,6798,12627,11594,1033,706
"2011","North East Lincolnshire","E06000012","Urban (total)",63246,40551,18805,21746,205,9803,3216,6587,12057,11088,969,630
"2011","North East Lincolnshire","E06000012","Urban major conurbation",0,0,0,0,0,0,0,0,0,0,0,0
"2011","North East Lincolnshire","E06000012","Urban minor conurbation",0,0,0,0,0,0,0,0,0,0,0,0
"2011","North East Lincolnshire","E06000012","Urban city and town",63246,40551,18805,21746,205,9803,3216,6587,12057,11088,969,630
"2011","North East Lincolnshire","E06000012","Urban city and town in a sparse setting",0,0,0,0,0,0,0,0,0,0,0,0
"2011","North East Lincolnshire","E06000012","Rural (total)",6461,5519,2692,2827,8,288,77,211,570,506,64,76
"2011","North East Lincolnshire","E06000012","Rural town and fringe",4522,3897,1800,2097,7,210,60,150,377,336,41,31
"2011","North East Lincolnshire","E06000012","Rural town and fringe in a sparse setting",0,0,0,0,0,0,0,0,0,0,0,0
"2011","North East Lincolnshire","E06000012","Rural village",1296,1084,586,498,1,64,10,54,120,105,15,27
"2011","North East Lincolnshire","E06000012","Rural village in a sparse setting",0,0,0,0,0,0,0,0,0,0,0,0
"2011","North East Lincolnshire","E06000012","Rural hamlet and isolated dwellings",643,538,306,232,0,14,7,7,73,65,8,18
"2011","North East Lincolnshire","E06000012","Rural hamlet and isolated dwellings in a sparse setting",0,0,0,0,0,0,0,0,0,0,0,0
"2011","North Lincolnshire","E06000013","Total",70684,49137,23355,25782,179,10895,4852,6043,9477,8493,984,996
"2011","North Lincolnshire","E06000013","Urban (total)",38798,24808,11403,13405,102,7684,3575,4109,5707,5195,512,497
"2011","North Lincolnshire","E06000013","Urban major conurbation",0,0,0,0,0,0,0,0,0,0,0,0
"2011","North Lincolnshire","E06000013","Urban minor conurbation",0,0,0,0,0,0,0,0,0,0,0,0
"2011","North Lincolnshire","E06000013","Urban city and town",38798,24808,11403,13405,102,7684,3575,4109,5707,5195,512,497
"2011","North Lincolnshire","E06000013","Urban city and town in a sparse setting",0,0,0,0,0,0,0,0,0,0,0,0
"2011","North Lincolnshire","E06000013","Rural (total)",31886,24329,11952,12377,77,3211,1277,1934,3770,3298,472,499
"2011","North Lincolnshire","E06000013","Rural town and fringe",20641,15666,7625,8041,47,2275,921,1354,2360,2083,277,293
"2011","North Lincolnshire","E06000013","Rural town and fringe in a sparse setting",0,0,0,0,0,0,0,0,0,0,0,0
"2011","North Lincolnshire","E06000013","Rural village",8311,6309,3141,3168,23,769,309,460,1068,928,140,142
"2011","North Lincolnshire","E06000013","Rural village in a sparse setting",0,0,0,0,0,0,0,0,0,0,0,0
"2011","North Lincolnshire","E06000013","Rural hamlet and isolated dwellings",2934,2354,1186,1168,7,167,47,120,342,287,55,64
"2011","North Lincolnshire","E06000013","Rural hamlet and isolated dwellings in a sparse setting",0,0,0,0,0,0,0,0,0,0,0,0
"2011","York","E06000014","Total",83552,55227,28351,26876,631,11679,7381,4298,14980,13687,1293,1035
"2011","York","E06000014","Urban (total)",70553,44290,22358,21932,582,10945,7000,3945,13852,12803,1049,884
"2011","York","E06000014","Urban major conurbation",0,0,0,0,0,0,0,0,0,0,0,0
"2011","York","E06000014","Urban minor conurbation",0,0,0,0,0,0,0,0,0,0,0,0
"2011","York","E06000014","Urban city and town",70553,44290,22358,21932,582,10945,7000,3945,13852,12803,1049,884
"2011","York","E06000014","Urban city and town in a sparse setting",0,0,0,0,0,0,0,0,0,0,0,0
"2011","York","E06000014","Rural (total)",12999,10937,5993,4944,49,734,381,353,1128,884,244,151
"2011","York","E06000014","Rural town and fringe",9631,8154,4467,3687,29,566,275,291,776,578,198,106
"2011","York","E06000014","Rural town and fringe in a sparse setting",0,0,0,0,0,0,0,0,0,0,0,0
"2011","York","E06000014","Rural village",2424,2027,1118,909,9,116,62,54,239,210,29,33
"2011","York","E06000014","Rural village in a sparse setting",0,0,0,0,0,0,0,0,0,0,0,0
"2011","York","E06000014","Rural hamlet and isolated dwellings",944,756,408,348,11,52,44,8,113,96,17,12
"2011","York","E06000014","Rural hamlet and isolated dwellings in a sparse setting",0,0,0,0,0,0,0,0,0,0,0,0
"2011","Craven","E07000163","Total",24583,17973,10396,7577,116,2212,558,1654,3782,3360,422,500
"2011","Craven","E07000163","Urban (total)",9980,6988,3712,3276,50,1202,310,892,1559,1404,155,181
"2011","Craven","E07000163","Urban major conurbation",0,0,0,0,0,0,0,0,0,0,0,0
"2011","Craven","E07000163","Urban minor conurbation",0,0,0,0,0,0,0,0,0,0,0,0
"2011","Craven","E07000163","Urban city and town",9980,6988,3712,3276,50,1202,310,892,1559,1404,155,181
"2011","Craven","E07000163","Urban city and town in a sparse setting",0,0,0,0,0,0,0,0,0,0,0,0
"2011","Craven","E07000163","Rural (total)",14603,10985,6684,4301,66,1010,248,762,2223,1956,267,319
"2011","Craven","E07000163","Rural town and fringe",3635,2722,1503,1219,21,371,98,273,465,416,49,56
"2011","Craven","E07000163","Rural town and fringe in a sparse setting",3240,2294,1472,822,10,385,93,292,479,426,53,72
"2011","Craven","E07000163","Rural village",2824,2281,1411,870,8,105,25,80,376,326,50,54
"2011","Craven","E07000163","Rural village in a sparse setting",1400,1056,704,352,8,75,17,58,225,196,29,36
"2011","Craven","E07000163","Rural hamlet and isolated dwellings",2231,1611,952,659,14,51,10,41,480,420,60,75
"2011","Craven","E07000163","Rural hamlet and isolated dwellings in a sparse setting",1273,1021,642,379,5,23,5,18,198,172,26,26
"2011","Hambleton","E07000164","Total",38117,26508,15135,11373,156,4923,372,4551,5770,4622,1148,760
"2011","Hambleton","E07000164","Urban (total)",7394,4926,2606,2320,32,1485,114,1371,877,787,90,74
"2011","Hambleton","E07000164","Urban major conurbation",0,0,0,0,0,0,0,0,0,0,0,0
"2011","Hambleton","E07000164","Urban minor conurbation",0,0,0,0,0,0,0,0,0,0,0,0
"2011","Hambleton","E07000164","Urban city and town",7394,4926,2606,2320,32,1485,114,1371,877,787,90,74
"2011","Hambleton","E07000164","Urban city and town in a sparse setting",0,0,0,0,0,0,0,0,0,0,0,0
"2011","Hambleton","E07000164","Rural (total)",30723,21582,12529,9053,124,3438,258,3180,4893,3835,1058,686
"2011","Hambleton","E07000164","Rural town and fringe",9940,6657,3920,2737,43,1668,128,1540,1411,1050,361,161
"2011","Hambleton","E07000164","Rural town and fringe in a sparse setting",3812,2391,1307,1084,8,648,60,588,701,635,66,64
"2011","Hambleton","E07000164","Rural village",9458,6879,3878,3001,37,828,35,793,1494,1030,464,220
"2011","Hambleton","E07000164","Rural village in a sparse setting",1144,849,499,350,7,66,9,57,185,156,29,37
"2011","Hambleton","E07000164","Rural hamlet and isolated dwellings",5495,4193,2579,1614,22,180,22,158,936,825,111,164
"2011","Hambleton","E07000164","Rural hamlet and isolated dwellings in a sparse setting",874,613,346,267,7,48,4,44,166,139,27,40
"2011","Harrogate","E07000165","Total",67169,47738,25118,22620,395,6138,3608,2530,11771,10394,1377,1127
"2011","Harrogate","E07000165","Urban (total)",45952,32091,16190,15901,291,4702,2588,2114,8287,7516,771,581
"2011","Harrogate","E07000165","Urban major conurbation",140,112,81,31,0,0,0,0,26,25,1,2
"2011","Harrogate","E07000165","Urban minor conurbation",0,0,0,0,0,0,0,0,0,0,0,0
"2011","Harrogate","E07000165","Urban city and town",45812,31979,16109,15870,291,4702,2588,2114,8261,7491,770,579
"2011","Harrogate","E07000165","Urban city and town in a sparse setting",0,0,0,0,0,0,0,0,0,0,0,0
"2011","Harrogate","E07000165","Rural (total)",21217,15647,8928,6719,104,1436,1020,416,3484,2878,606,546
"2011","Harrogate","E07000165","Rural town and fringe",2971,2148,1082,1066,16,259,186,73,500,457,43,48
"2011","Harrogate","E07000165","Rural town and fringe in a sparse setting",592,357,233,124,5,101,79,22,122,101,21,7
"2011","Harrogate","E07000165","Rural village",10593,8036,4544,3492,60,774,559,215,1510,1151,359,213
"2011","Harrogate","E07000165","Rural village in a sparse setting",238,163,80,83,1,38,16,22,35,32,3,1
"2011","Harrogate","E07000165","Rural hamlet and isolated dwellings",6419,4693,2826,1867,19,261,178,83,1188,1021,167,258
"2011","Harrogate","E07000165","Rural hamlet and isolated dwellings in a sparse setting",404,250,163,87,3,3,2,1,129,116,13,19
"2011","Richmondshire","E07000166","Total",20207,12910,7295,5615,104,2183,1451,732,4519,2877,1642,491
"2011","Richmondshire","E07000166","Urban (total)",2780,1057,321,736,6,233,86,147,1450,411,1039,34
"2011","Richmondshire","E07000166","Urban major conurbation",0,0,0,0,0,0,0,0,0,0,0,0
"2011","Richmondshire","E07000166","Urban minor conurbation",0,0,0,0,0,0,0,0,0,0,0,0
"2011","Richmondshire","E07000166","Urban city and town",2780,1057,321,736,6,233,86,147,1450,411,1039,34
"2011","Richmondshire","E07000166","Urban city and town in a sparse setting",0,0,0,0,0,0,0,0,0,0,0,0
"2011","Richmondshire","E07000166","Rural (total)",17427,11853,6974,4879,98,1950,1365,585,3069,2466,603,457
"2011","Richmondshire","E07000166","Rural town and fringe",7019,4556,2368,2188,41,1194,851,343,1118,906,212,110
"2011","Richmondshire","E07000166","Rural town and fringe in a sparse setting",1050,732,488,244,17,97,78,19,176,148,28,28
"2011","Richmondshire","E07000166","Rural village",3718,2773,1539,1234,9,301,256,45,528,459,69,107
"2011","Richmondshire","E07000166","Rural village in a sparse setting",2924,2012,1386,626,15,235,123,112,569,459,110,93
"2011","Richmondshire","E07000166","Rural hamlet and isolated dwellings",1291,778,452,326,6,40,17,23,416,280,136,51
"2011","Richmondshire","E07000166","Rural hamlet and isolated dwellings in a sparse setting",1425,1002,741,261,10,83,40,43,262,214,48,68
"2011","Ryedale","E07000167","Total",22524,15124,9329,5795,83,2896,213,2683,3773,3321,452,648
"2011","Ryedale","E07000167","Urban (total)",5300,3324,1825,1499,15,1031,76,955,855,774,81,75
"2011","Ryedale","E07000167","Urban major conurbation",0,0,0,0,0,0,0,0,0,0,0,0
"2011","Ryedale","E07000167","Urban minor conurbation",0,0,0,0,0,0,0,0,0,0,0,0
"2011","Ryedale","E07000167","Urban city and town",5300,3324,1825,1499,15,1031,76,955,855,774,81,75
"2011","Ryedale","E07000167","Urban city and town in a sparse setting",0,0,0,0,0,0,0,0,0,0,0,0
"2011","Ryedale","E07000167","Rural (total)",17224,11800,7504,4296,68,1865,137,1728,2918,2547,371,573
"2011","Ryedale","E07000167","Rural town and fringe",0,0,0,0,0,0,0,0,0,0,0,0
"2011","Ryedale","E07000167","Rural town and fringe in a sparse setting",5697,3885,2598,1287,34,841,73,768,822,723,99,115
"2011","Ryedale","E07000167","Rural village",4642,3159,1873,1286,19,523,40,483,784,664,120,157
"2011","Ryedale","E07000167","Rural village in a sparse setting",2639,1967,1281,686,6,260,10,250,333,290,43,73
"2011","Ryedale","E07000167","Rural hamlet and isolated dwellings",2818,1791,1097,694,6,183,10,173,682,610,72,156
"2011","Ryedale","E07000167","Rural hamlet and isolated dwellings in a sparse setting",1428,998,655,343,3,58,4,54,297,260,37,72
"2011","Scarborough","E07000168","Total",49435,32520,19323,13197,302,6134,1163,4971,9640,8812,828,839
"2011","Scarborough","E07000168","Urban (total)",34134,20973,11795,9178,215,4819,928,3891,7610,7022,588,517
"2011","Scarborough","E07000168","Urban major conurbation",0,0,0,0,0,0,0,0,0,0,0,0
"2011","Scarborough","E07000168","Urban minor conurbation",0,0,0,0,0,0,0,0,0,0,0,0
"2011","Scarborough","E07000168","Urban city and town",28037,17140,9461,7679,193,3810,776,3034,6505,6032,473,389
"2011","Scarborough","E07000168","Urban city and town in a sparse setting",6097,3833,2334,1499,22,1009,152,857,1105,990,115,128
"2011","Scarborough","E07000168","Rural (total)",15301,11547,7528,4019,87,1315,235,1080,2030,1790,240,322
"2011","Scarborough","E07000168","Rural town and fringe",7003,5235,3413,1822,41,725,137,588,906,818,88,96
"2011","Scarborough","E07000168","Rural town and fringe in a sparse setting",645,466,307,159,0,116,17,99,48,45,3,15
"2011","Scarborough","E07000168","Rural village",3038,2344,1467,877,15,229,42,187,389,328,61,61
"2011","Scarborough","E07000168","Rural village in a sparse setting",2021,1596,1095,501,9,148,27,121,233,194,39,35
"2011","Scarborough","E07000168","Rural hamlet and isolated dwellings",1774,1339,876,463,22,65,10,55,282,250,32,66
"2011","Scarborough","E07000168","Rural hamlet and isolated dwellings in a sparse setting",820,567,370,197,0,32,2,30,172,155,17,49
"2011","Selby","E07000169","Total",34559,25911,11929,13982,201,4161,2902,1259,3796,3400,396,490
"2011","Selby","E07000169","Urban (total)",11470,7622,3538,4084,88,2077,1264,813,1548,1421,127,135
"2011","Selby","E07000169","Urban major conurbation",0,0,0,0,0,0,0,0,0,0,0,0
"2011","Selby","E07000169","Urban minor conurbation",0,0,0,0,0,0,0,0,0,0,0,0
"2011","Selby","E07000169","Urban city and town",11470,7622,3538,4084,88,2077,1264,813,1548,1421,127,135
"2011","Selby","E07000169","Urban city and town in a sparse setting",0,0,0,0,0,0,0,0,0,0,0,0
"2011","Selby","E07000169","Rural (total)",23089,18289,8391,9898,113,2084,1638,446,2248,1979,269,355
"2011","Selby","E07000169","Rural town and fringe",13110,10201,4597,5604,72,1426,1094,332,1244,1096,148,167
"2011","Selby","E07000169","Rural town and fringe in a sparse setting",0,0,0,0,0,0,0,0,0,0,0,0
"2011","Selby","E07000169","Rural village",7801,6402,2956,3446,35,522,432,90,721,644,77,121
"2011","Selby","E07000169","Rural village in a sparse setting",0,0,0,0,0,0,0,0,0,0,0,0
"2011","Selby","E07000169","Rural hamlet and isolated dwellings",2178,1686,838,848,6,136,112,24,283,239,44,67
"2011","Selby","E07000169","Rural hamlet and isolated dwellings in a sparse setting",0,0,0,0,0,0,0,0,0,0,0,0
"2011","Barnsley","E08000016","Total",100734,64807,30778,34029,445,21032,17831,3201,12856,11812,1044,1594
"2011","Barnsley","E08000016","Urban (total)",90501,57585,27207,30378,399,19490,16576,2914,11588,10653,935,1439
"2011","Barnsley","E08000016","Urban major conurbation",0,0,0,0,0,0,0,0,0,0,0,0
"2011","Barnsley","E08000016","Urban minor conurbation",80898,50575,23806,26769,354,17918,15206,2712,10736,9885,851,1315
"2011","Barnsley","E08000016","Urban city and town",9603,7010,3401,3609,45,1572,1370,202,852,768,84,124
"2011","Barnsley","E08000016","Urban city and town in a sparse setting",0,0,0,0,0,0,0,0,0,0,0,0
"2011","Barnsley","E08000016","Rural (total)",10233,7222,3571,3651,46,1542,1255,287,1268,1159,109,155
"2011","Barnsley","E08000016","Rural town and fringe",6067,3983,1805,2178,24,1197,952,245,787,722,65,76
"2011","Barnsley","E08000016","Rural town and fringe in a sparse setting",0,0,0,0,0,0,0,0,0,0,0,0
"2011","Barnsley","E08000016","Rural village",2573,1997,1101,896,19,271,238,33,246,226,20,40
"2011","Barnsley","E08000016","Rural village in a sparse setting",0,0,0,0,0,0,0,0,0,0,0,0
"2011","Barnsley","E08000016","Rural hamlet and isolated dwellings",1593,1242,665,577,3,74,65,9,235,211,24,39
"2011","Barnsley","E08000016","Rural hamlet and isolated dwellings in a sparse setting",0,0,0,0,0,0,0,0,0,0,0,0
"2011","Doncaster","E08000017","Total",126487,82760,39253,43507,418,22403,19173,3230,18774,17084,1690,2132
"2011","Doncaster","E08000017","Urban (total)",109466,69944,32453,37491,347,20615,17713,2902,16737,15242,1495,1823
"2011","Doncaster","E08000017","Urban major conurbation",0,0,0,0,0,0,0,0,0,0,0,0
"2011","Doncaster","E08000017","Urban minor conurbation",90470,56870,25897,30973,293,17357,14863,2494,14429,13184,1245,1521
"2011","Doncaster","E08000017","Urban city and town",18996,13074,6556,6518,54,3258,2850,408,2308,2058,250,302
"2011","Doncaster","E08000017","Urban city and town in a sparse setting",0,0,0,0,0,0,0,0,0,0,0,0
"2011","Doncaster","E08000017","Rural (total)",17021,12816,6800,6016,71,1788,1460,328,2037,1842,195,309
"2011","Doncaster","E08000017","Rural town and fringe",11595,8447,4386,4061,55,1533,1259,274,1369,1247,122,191
"2011","Doncaster","E08000017","Rural town and fringe in a sparse setting",0,0,0,0,0,0,0,0,0,0,0,0
"2011","Doncaster","E08000017","Rural village",3591,2873,1555,1318,10,189,146,43,450,402,48,69
"2011","Doncaster","E08000017","Rural village in a sparse setting",0,0,0,0,0,0,0,0,0,0,0,0
"2011","Doncaster","E08000017","Rural hamlet and isolated dwellings",1835,1496,859,637,6,66,55,11,218,193,25,49
"2011","Doncaster","E08000017","Rural hamlet and isolated dwellings in a sparse setting",0,0,0,0,0,0,0,0,0,0,0,0
"2011","Rotherham","E08000018","Total",108293,70610,33031,37579,309,23289,19436,3853,12262,11153,1109,1823
"2011","Rotherham","E08000018","Urban (total)",97116,62707,29142,33565,284,21697,18009,3688,10835,9861,974,1593
"2011","Rotherham","E08000018","Urban major conurbation",0,0,0,0,0,0,0,0,0,0,0,0
"2011","Rotherham","E08000018","Urban minor conurbation",78113,49171,22935,26236,246,18797,15779,3018,8568,7795,773,1331
"2011","Rotherham","E08000018","Urban city and town",19003,13536,6207,7329,38,2900,2230,670,2267,2066,201,262
"2011","Rotherham","E08000018","Urban city and town in a sparse setting",0,0,0,0,0,0,0,0,0,0,0,0
"2011","Rotherham","E08000018","Rural (total)",11177,7903,3889,4014,25,1592,1427,165,1427,1292,135,230
"2011","Rotherham","E08000018","Rural town and fringe",8734,6073,2827,3246,22,1443,1323,120,1032,935,97,164
"2011","Rotherham","E08000018","Rural town and fringe in a sparse setting",0,0,0,0,0,0,0,0,0,0,0,0
"2011","Rotherham","E08000018","Rural village",1692,1269,725,544,2,125,90,35,253,228,25,43
"2011","Rotherham","E08000018","Rural village in a sparse setting",0,0,0,0,0,0,0,0,0,0,0,0
"2011","Rotherham","E08000018","Rural hamlet and isolated dwellings",751,561,337,224,1,24,14,10,142,129,13,23
"2011","Rotherham","E08000018","Rural hamlet and isolated dwellings in a sparse setting",0,0,0,0,0,0,0,0,0,0,0,0
"2011","Sheffield","E08000019","Total",229928,134127,62329,71798,881,56917,40725,16192,35760,32605,3155,2243
"2011","Sheffield","E08000019","Urban (total)",225860,130969,60801,70168,871,56459,40311,16148,35372,32277,3095,2189
"2011","Sheffield","E08000019","Urban major conurbation",0,0,0,0,0,0,0,0,0,0,0,0
"2011","Sheffield","E08000019","Urban minor conurbation",218544,125578,58090,67488,856,55359,39349,16010,34652,31634,3018,2099
"2011","Sheffield","E08000019","Urban city and town",7316,5391,2711,2680,15,1100,962,138,720,643,77,90
"2011","Sheffield","E08000019","Urban city and town in a sparse setting",0,0,0,0,0,0,0,0,0,0,0,0
"2011","Sheffield","E08000019","Rural (total)",4068,3158,1528,1630,10,458,414,44,388,328,60,54
"2011","Sheffield","E08000019","Rural town and fringe",2561,2078,970,1108,7,280,264,16,174,154,20,22
"2011","Sheffield","E08000019","Rural town and fringe in a sparse setting",0,0,0,0,0,0,0,0,0,0,0,0
"2011","Sheffield","E08000019","Rural village",702,499,243,256,1,107,100,7,86,66,20,9
"2011","Sheffield","E08000019","Rural village in a sparse setting",0,0,0,0,0,0,0,0,0,0,0,0
"2011","Sheffield","E08000019","Rural hamlet and isolated dwellings",805,581,315,266,2,71,50,21,128,108,20,23
"2011","Sheffield","E08000019","Rural hamlet and isolated dwellings in a sparse setting",0,0,0,0,0,0,0,0,0,0,0,0
"2011","Bradford","E08000032","Total",199296,129550,58487,71063,1165,29513,11729,17784,36070,33135,2935,2998
"2011","Bradford","E08000032","Urban (total)",183887,117407,52470,64937,1112,28482,11320,17162,34085,31378,2707,2801
"2011","Bradford","E08000032","Urban major conurbation",148110,91801,40037,51764,863,24725,9866,14859,28435,26236,2199,2286
"2011","Bradford","E08000032","Urban minor conurbation",0,0,0,0,0,0,0,0,0,0,0,0
"2011","Bradford","E08000032","Urban city and town",35777,25606,12433,13173,249,3757,1454,2303,5650,5142,508,515
"2011","Bradford","E08000032","Urban city and town in a sparse setting",0,0,0,0,0,0,0,0,0,0,0,0
"2011","Bradford","E08000032","Rural (total)",15409,12143,6017,6126,53,1031,409,622,1985,1757,228,197
"2011","Bradford","E08000032","Rural town and fringe",11581,9022,4356,4666,36,907,357,550,1487,1329,158,129
"2011","Bradford","E08000032","Rural town and fringe in a sparse setting",0,0,0,0,0,0,0,0,0,0,0,0
"2011","Bradford","E08000032","Rural village",506,374,168,206,4,20,10,10,100,89,11,8
"2011","Bradford","E08000032","Rural village in a sparse setting",0,0,0,0,0,0,0,0,0,0,0,0
"2011","Bradford","E08000032","Rural hamlet and isolated dwellings",3322,2747,1493,1254,13,104,42,62,398,339,59,60
"2011","Bradford","E08000032","Rural hamlet and isolated dwellings in a sparse setting",0,0,0,0,0,0,0,0,0,0,0,0
"2011","Calderdale","E08000033","Total",88621,58981,27671,31310,397,13494,4753,8741,14545,13114,1431,1204
"2011","Calderdale","E08000033","Urban (total)",71375,46211,21627,24584,299,11910,4327,7583,11967,10801,1166,988
"2011","Calderdale","E08000033","Urban major conurbation",64298,41739,19450,22289,243,10663,3890,6773,10780,9738,1042,873
"2011","Calderdale","E08000033","Urban minor conurbation",0,0,0,0,0,0,0,0,0,0,0,0
"2011","Calderdale","E08000033","Urban city and town",7077,4472,2177,2295,56,1247,437,810,1187,1063,124,115
"2011","Calderdale","E08000033","Urban city and town in a sparse setting",0,0,0,0,0,0,0,0,0,0,0,0
"2011","Calderdale","E08000033","Rural (total)",17246,12770,6044,6726,98,1584,426,1158,2578,2313,265,216
"2011","Calderdale","E08000033","Rural town and fringe",9136,6119,2717,3402,64,1311,345,966,1530,1395,135,112
"2011","Calderdale","E08000033","Rural town and fringe in a sparse setting",0,0,0,0,0,0,0,0,0,0,0,0
"2011","Calderdale","E08000033","Rural village",3154,2515,1267,1248,24,161,44,117,421,383,38,33
"2011","Calderdale","E08000033","Rural village in a sparse setting",0,0,0,0,0,0,0,0,0,0,0,0
"2011","Calderdale","E08000033","Rural hamlet and isolated dwellings",4956,4136,2060,2076,10,112,37,75,627,535,92,71
"2011","Calderdale","E08000033","Rural hamlet and isolated dwellings in a sparse setting",0,0,0,0,0,0,0,0,0,0,0,0
"2011","Kirklees","E08000034","Total",173525,116361,55569,60792,612,26525,20886,5639,26941,24523,2418,3086
"2011","Kirklees","E08000034","Urban (total)",153520,100610,47739,52871,540,25096,19680,5416,24505,22327,2178,2769
"2011","Kirklees","E08000034","Urban major conurbation",144104,93123,43953,49170,510,24489,19152,5337,23319,21279,2040,2663
"2011","Kirklees","E08000034","Urban minor conurbation",0,0,0,0,0,0,0,0,0,0,0,0
"2011","Kirklees","E08000034","Urban city and town",9416,7487,3786,3701,30,607,528,79,1186,1048,138,106
"2011","Kirklees","E08000034","Urban city and town in a sparse setting",0,0,0,0,0,0,0,0,0,0,0,0
"2011","Kirklees","E08000034","Rural (total)",20005,15751,7830,7921,72,1429,1206,223,2436,2196,240,317
"2011","Kirklees","E08000034","Rural town and fringe",14035,10782,5182,5600,47,1234,1033,201,1757,1588,169,215
"2011","Kirklees","E08000034","Rural town and fringe in a sparse setting",0,0,0,0,0,0,0,0,0,0,0,0
"2011","Kirklees","E08000034","Rural village",3280,2779,1509,1270,17,130,123,7,301,268,33,53
"2011","Kirklees","E08000034","Rural village in a sparse setting",0,0,0,0,0,0,0,0,0,0,0,0
"2011","Kirklees","E08000034","Rural hamlet and isolated dwellings",2690,2190,1139,1051,8,65,50,15,378,340,38,49
"2011","Kirklees","E08000034","Rural hamlet and isolated dwellings in a sparse setting",0,0,0,0,0,0,0,0,0,0,0,0
"2011","Leeds","E08000035","Total",320596,186467,83385,103082,1442,70377,54122,16255,57456,53599,3857,4854
"2011","Leeds","E08000035","Urban (total)",302423,172359,76134,96225,1347,68431,52460,15971,55722,52038,3684,4564
"2011","Leeds","E08000035","Urban major conurbation",280138,154864,67412,87452,1248,65934,50388,15546,53806,50298,3508,4286
"2011","Leeds","E08000035","Urban minor conurbation",0,0,0,0,0,0,0,0,0,0,0,0
"2011","Leeds","E08000035","Urban city and town",22285,17495,8722,8773,99,2497,2072,425,1916,1740,176,278
"2011","Leeds","E08000035","Urban city and town in a sparse setting",0,0,0,0,0,0,0,0,0,0,0,0
"2011","Leeds","E08000035","Rural (total)",18173,14108,7251,6857,95,1946,1662,284,1734,1561,173,290
"2011","Leeds","E08000035","Rural town and fringe",13069,10090,5141,4949,76,1598,1391,207,1124,1016,108,181
"2011","Leeds","E08000035","Rural town and fringe in a sparse setting",0,0,0,0,0,0,0,0,0,0,0,0
"2011","Leeds","E08000035","Rural village",3540,2753,1409,1344,9,271,202,69,434,385,49,73
"2011","Leeds","E08000035","Rural village in a sparse setting",0,0,0,0,0,0,0,0,0,0,0,0
"2011","Leeds","E08000035","Rural hamlet and isolated dwellings",1564,1265,701,564,10,77,69,8,176,160,16,36
"2011","Leeds","E08000035","Rural hamlet and isolated dwellings in a sparse setting",0,0,0,0,0,0,0,0,0,0,0,0
"2011","Wakefield","E08000036","Total",140414,89291,40766,48525,650,33129,24136,8993,16017,14383,1634,1327
"2011","Wakefield","E08000036","Urban (total)",115954,72161,32642,39519,574,28666,20867,7799,13482,12148,1334,1071
"2011","Wakefield","E08000036","Urban major conurbation",55626,34835,16140,18695,263,12907,9113,3794,7071,6423,648,550
"2011","Wakefield","E08000036","Urban minor conurbation",0,0,0,0,0,0,0,0,0,0,0,0
"2011","Wakefield","E08000036","Urban city and town",60328,37326,16502,20824,311,15759,11754,4005,6411,5725,686,521
"2011","Wakefield","E08000036","Urban city and town in a sparse setting",0,0,0,0,0,0,0,0,0,0,0,0
"2011","Wakefield","E08000036","Rural (total)",24460,17130,8124,9006,76,4463,3269,1194,2535,2235,300,256
"2011","Wakefield","E08000036","Rural town and fringe",18921,12672,5709,6963,57,3977,2921,1056,2014,1780,234,201
"2011","Wakefield","E08000036","Rural town and fringe in a sparse setting",0,0,0,0,0,0,0,0,0,0,0,0
"2011","Wakefield","E08000036","Rural village",4603,3649,1996,1653,16,464,338,126,429,373,56,45
"2011","Wakefield","E08000036","Rural village in a sparse setting",0,0,0,0,0,0,0,0,0,0,0,0
"2011","Wakefield","E08000036","Rural hamlet and isolated dwellings",936,809,419,390,3,22,10,12,92,82,10,10
"2011","Wakefield","E08000036","Rural hamlet and isolated dwellings in a sparse setting",0,0,0,0,0,0,0,0,0,0,0,0
"2011","Derby","E06000015","Total",102271,62765,30239,32526,864,20250,12458,7792,17193,15943,1250,1199
"2011","Derby","E06000015","Urban (total)",102271,62765,30239,32526,864,20250,12458,7792,17193,15943,1250,1199
"2011","Derby","E06000015","Urban major conurbation",0,0,0,0,0,0,0,0,0,0,0,0
"2011","Derby","E06000015","Urban minor conurbation",0,0,0,0,0,0,0,0,0,0,0,0
"2011","Derby","E06000015","Urban city and town",102271,62765,30239,32526,864,20250,12458,7792,17193,15943,1250,1199
"2011","Derby","E06000015","Urban city and town in a sparse setting",0,0,0,0,0,0,0,0,0,0,0,0
"2011","Derby","E06000015","Rural (total)",0,0,0,0,0,0,0,0,0,0,0,0
"2011","Derby","E06000015","Rural town and fringe",0,0,0,0,0,0,0,0,0,0,0,0
"2011","Derby","E06000015","Rural town and fringe in a sparse setting",0,0,0,0,0,0,0,0,0,0,0,0
"2011","Derby","E06000015","Rural village",0,0,0,0,0,0,0,0,0,0,0,0
"2011","Derby","E06000015","Rural village in a sparse setting",0,0,0,0,0,0,0,0,0,0,0,0
"2011","Derby","E06000015","Rural hamlet and isolated dwellings",0,0,0,0,0,0,0,0,0,0,0,0
"2011","Derby","E06000015","Rural hamlet and isolated dwellings in a sparse setting",0,0,0,0,0,0,0,0,0,0,0,0
"2011","Leicester","E06000016","Total",123125,61170,28018,33152,774,31270,21048,10222,27999,26207,1792,1912
"2011","Leicester","E06000016","Urban (total)",122951,61021,27970,33051,773,31259,21040,10219,27986,26194,1792,1912
"2011","Leicester","E06000016","Urban major conurbation",0,0,0,0,0,0,0,0,0,0,0,0
"2011","Leicester","E06000016","Urban minor conurbation",0,0,0,0,0,0,0,0,0,0,0,0
"2011","Leicester","E06000016","Urban city and town",122951,61021,27970,33051,773,31259,21040,10219,27986,26194,1792,1912
"2011","Leicester","E06000016","Urban city and town in a sparse setting",0,0,0,0,0,0,0,0,0,0,0,0
"2011","Leicester","E06000016","Rural (total)",174,149,48,101,1,11,8,3,13,13,0,0
"2011","Leicester","E06000016","Rural town and fringe",0,0,0,0,0,0,0,0,0,0,0,0
"2011","Leicester","E06000016","Rural town and fringe in a sparse setting",0,0,0,0,0,0,0,0,0,0,0,0
"2011","Leicester","E06000016","Rural village",0,0,0,0,0,0,0,0,0,0,0,0
"2011","Leicester","E06000016","Rural village in a sparse setting",0,0,0,0,0,0,0,0,0,0,0,0
"2011","Leicester","E06000016","Rural hamlet and isolated dwellings",174,149,48,101,1,11,8,3,13,13,0,0
"2011","Leicester","E06000016","Rural hamlet and isolated dwellings in a sparse setting",0,0,0,0,0,0,0,0,0,0,0,0
"2011","Nottingham","E06000018","Total",126131,56867,25152,31715,786,37486,26176,11310,29098,27300,1798,1894
"2011","Nottingham","E06000018","Urban (total)",126131,56867,25152,31715,786,37486,26176,11310,29098,27300,1798,1894
"2011","Nottingham","E06000018","Urban major conurbation",0,0,0,0,0,0,0,0,0,0,0,0
"2011","Nottingham","E06000018","Urban minor conurbation",126131,56867,25152,31715,786,37486,26176,11310,29098,27300,1798,1894
"2011","Nottingham","E06000018","Urban city and town",0,0,0,0,0,0,0,0,0,0,0,0
"2011","Nottingham","E06000018","Urban city and town in a sparse setting",0,0,0,0,0,0,0,0,0,0,0,0
"2011","Nottingham","E06000018","Rural (total)",0,0,0,0,0,0,0,0,0,0,0,0
"2011","Nottingham","E06000018","Rural town and fringe",0,0,0,0,0,0,0,0,0,0,0,0
"2011","Nottingham","E06000018","Rural town and fringe in a sparse setting",0,0,0,0,0,0,0,0,0,0,0,0
"2011","Nottingham","E06000018","Rural village",0,0,0,0,0,0,0,0,0,0,0,0
"2011","Nottingham","E06000018","Rural village in a sparse setting",0,0,0,0,0,0,0,0,0,0,0,0
"2011","Nottingham","E06000018","Rural hamlet and isolated dwellings",0,0,0,0,0,0,0,0,0,0,0,0
"2011","Nottingham","E06000018","Rural hamlet and isolated dwellings in a sparse setting",0,0,0,0,0,0,0,0,0,0,0,0
"2011","Rutland","E06000017","Total",15002,10556,5889,4667,160,1685,369,1316,2333,1741,592,268
"2011","Rutland","E06000017","Urban (total)",4904,3395,1859,1536,66,668,142,526,689,621,68,86
"2011","Rutland","E06000017","Urban major conurbation",0,0,0,0,0,0,0,0,0,0,0,0
"2011","Rutland","E06000017","Urban minor conurbation",0,0,0,0,0,0,0,0,0,0,0,0
"2011","Rutland","E06000017","Urban city and town",4904,3395,1859,1536,66,668,142,526,689,621,68,86
"2011","Rutland","E06000017","Urban city and town in a sparse setting",0,0,0,0,0,0,0,0,0,0,0,0
"2011","Rutland","E06000017","Rural (total)",10098,7161,4030,3131,94,1017,227,790,1644,1120,524,182
"2011","Rutland","E06000017","Rural town and fringe",3617,2616,1439,1177,29,476,113,363,446,370,76,50
"2011","Rutland","E06000017","Rural town and fringe in a sparse setting",0,0,0,0,0,0,0,0,0,0,0,0
"2011","Rutland","E06000017","Rural village",6219,4358,2491,1867,59,517,114,403,1158,712,446,127
"2011","Rutland","E06000017","Rural village in a sparse setting",0,0,0,0,0,0,0,0,0,0,0,0
"2011","Rutland","E06000017","Rural hamlet and isolated dwellings",262,187,100,87,6,24,0,24,40,38,2,5
"2011","Rutland","E06000017","Rural hamlet and isolated dwellings in a sparse setting",0,0,0,0,0,0,0,0,0,0,0,0
"2011","Amber Valley","E07000032","Total",52596,38974,20106,18868,216,6484,2708,3776,6200,5618,582,722
"2011","Amber Valley","E07000032","Urban (total)",42446,30908,15543,15365,182,5599,2359,3240,5173,4708,465,584
"2011","Amber Valley","E07000032","Urban major conurbation",0,0,0,0,0,0,0,0,0,0,0,0
"2011","Amber Valley","E07000032","Urban minor conurbation",28623,20050,9994,10056,99,4551,1910,2641,3506,3184,322,417
"2011","Amber Valley","E07000032","Urban city and town",13823,10858,5549,5309,83,1048,449,599,1667,1524,143,167
"2011","Amber Valley","E07000032","Urban city and town in a sparse setting",0,0,0,0,0,0,0,0,0,0,0,0
"2011","Amber Valley","E07000032","Rural (total)",10150,8066,4563,3503,34,885,349,536,1027,910,117,138
"2011","Amber Valley","E07000032","Rural town and fringe",4166,3161,1653,1508,11,530,192,338,415,365,50,49
"2011","Amber Valley","E07000032","Rural town and fringe in a sparse setting",0,0,0,0,0,0,0,0,0,0,0,0
"2011","Amber Valley","E07000032","Rural village",3519,2907,1676,1231,13,264,123,141,287,250,37,48
"2011","Amber Valley","E07000032","Rural village in a sparse setting",0,0,0,0,0,0,0,0,0,0,0,0
"2011","Amber Valley","E07000032","Rural hamlet and isolated dwellings",2465,1998,1234,764,10,91,34,57,325,295,30,41
"2011","Amber Valley","E07000032","Rural hamlet and isolated dwellings in a sparse setting",0,0,0,0,0,0,0,0,0,0,0,0
"2011","Bolsover","E07000033","Total",32801,21963,10691,11272,92,5965,4922,1043,4276,3871,405,505
"2011","Bolsover","E07000033","Urban (total)",17353,11427,5560,5867,58,3243,2593,650,2373,2168,205,252
"2011","Bolsover","E07000033","Urban major conurbation",0,0,0,0,0,0,0,0,0,0,0,0
"2011","Bolsover","E07000033","Urban minor conurbation",6263,4494,2042,2452,15,828,657,171,855,790,65,71
"2011","Bolsover","E07000033","Urban city and town",11090,6933,3518,3415,43,2415,1936,479,1518,1378,140,181
"2011","Bolsover","E07000033","Urban city and town in a sparse setting",0,0,0,0,0,0,0,0,0,0,0,0
"2011","Bolsover","E07000033","Rural (total)",15448,10536,5131,5405,34,2722,2329,393,1903,1703,200,253
"2011","Bolsover","E07000033","Rural town and fringe",13084,8864,4284,4580,22,2407,2042,365,1590,1430,160,201
"2011","Bolsover","E07000033","Rural town and fringe in a sparse setting",0,0,0,0,0,0,0,0,0,0,0,0
"2011","Bolsover","E07000033","Rural village",1976,1365,657,708,12,288,264,24,270,240,30,41
"2011","Bolsover","E07000033","Rural village in a sparse setting",0,0,0,0,0,0,0,0,0,0,0,0
"2011","Bolsover","E07000033","Rural hamlet and isolated dwellings",388,307,190,117,0,27,23,4,43,33,10,11
"2011","Bolsover","E07000033","Rural hamlet and isolated dwellings in a sparse setting",0,0,0,0,0,0,0,0,0,0,0,0
"2011","Chesterfield","E07000034","Total",46796,29547,15065,14482,156,10832,9385,1447,5813,5291,522,448
"2011","Chesterfield","E07000034","Urban (total)",46074,29212,14908,14304,154,10515,9094,1421,5747,5231,516,446
"2011","Chesterfield","E07000034","Urban major conurbation",0,0,0,0,0,0,0,0,0,0,0,0
"2011","Chesterfield","E07000034","Urban minor conurbation",0,0,0,0,0,0,0,0,0,0,0,0
"2011","Chesterfield","E07000034","Urban city and town",46074,29212,14908,14304,154,10515,9094,1421,5747,5231,516,446
"2011","Chesterfield","E07000034","Urban city and town in a sparse setting",0,0,0,0,0,0,0,0,0,0,0,0
"2011","Chesterfield","E07000034","Rural (total)",722,335,157,178,2,317,291,26,66,60,6,2
"2011","Chesterfield","E07000034","Rural town and fringe",417,185,80,105,1,188,168,20,41,39,2,2
"2011","Chesterfield","E07000034","Rural town and fringe in a sparse setting",0,0,0,0,0,0,0,0,0,0,0,0
"2011","Chesterfield","E07000034","Rural village",203,76,31,45,0,110,107,3,17,14,3,0
"2011","Chesterfield","E07000034","Rural village in a sparse setting",0,0,0,0,0,0,0,0,0,0,0,0
"2011","Chesterfield","E07000034","Rural hamlet and isolated dwellings",102,74,46,28,1,19,16,3,8,7,1,0
"2011","Chesterfield","E07000034","Rural hamlet and isolated dwellings in a sparse setting",0,0,0,0,0,0,0,0,0,0,0,0
"2011","Derbyshire Dales","E07000035","Total",30744,22269,13513,8756,229,3736,1330,2406,3860,3423,437,650
"2011","Derbyshire Dales","E07000035","Urban (total)",6670,4819,2796,2023,27,1026,335,691,716,641,75,82
"2011","Derbyshire Dales","E07000035","Urban major conurbation",0,0,0,0,0,0,0,0,0,0,0,0
"2011","Derbyshire Dales","E07000035","Urban minor conurbation",0,0,0,0,0,0,0,0,0,0,0,0
"2011","Derbyshire Dales","E07000035","Urban city and town",6670,4819,2796,2023,27,1026,335,691,716,641,75,82
"2011","Derbyshire Dales","E07000035","Urban city and town in a sparse setting",0,0,0,0,0,0,0,0,0,0,0,0
"2011","Derbyshire Dales","E07000035","Rural (total)",24074,17450,10717,6733,202,2710,995,1715,3144,2782,362,568
"2011","Derbyshire Dales","E07000035","Rural town and fringe",10533,7203,4292,2911,131,1757,668,1089,1288,1170,118,154
"2011","Derbyshire Dales","E07000035","Rural town and fringe in a sparse setting",0,0,0,0,0,0,0,0,0,0,0,0
"2011","Derbyshire Dales","E07000035","Rural village",9923,7442,4666,2776,49,836,292,544,1281,1097,184,315
"2011","Derbyshire Dales","E07000035","Rural village in a sparse setting",0,0,0,0,0,0,0,0,0,0,0,0
"2011","Derbyshire Dales","E07000035","Rural hamlet and isolated dwellings",3618,2805,1759,1046,22,117,35,82,575,515,60,99
"2011","Derbyshire Dales","E07000035","Rural hamlet and isolated dwellings in a sparse setting",0,0,0,0,0,0,0,0,0,0,0,0
"2011","Erewash","E07000036","Total",48692,35290,16506,18784,242,6335,1978,4357,6265,5762,503,560
"2011","Erewash","E07000036","Urban (total)",47862,34628,16112,18516,241,6269,1966,4303,6175,5680,495,549
"2011","Erewash","E07000036","Urban major conurbation",0,0,0,0,0,0,0,0,0,0,0,0
"2011","Erewash","E07000036","Urban minor conurbation",38839,27470,12424,15046,205,5384,1714,3670,5333,4927,406,447
"2011","Erewash","E07000036","Urban city and town",9023,7158,3688,3470,36,885,252,633,842,753,89,102
"2011","Erewash","E07000036","Urban city and town in a sparse setting",0,0,0,0,0,0,0,0,0,0,0,0
"2011","Erewash","E07000036","Rural (total)",830,662,394,268,1,66,12,54,90,82,8,11
"2011","Erewash","E07000036","Rural town and fringe",0,0,0,0,0,0,0,0,0,0,0,0
"2011","Erewash","E07000036","Rural town and fringe in a sparse setting",0,0,0,0,0,0,0,0,0,0,0,0
"2011","Erewash","E07000036","Rural village",712,569,341,228,1,62,11,51,70,63,7,10
"2011","Erewash","E07000036","Rural village in a sparse setting",0,0,0,0,0,0,0,0,0,0,0,0
"2011","Erewash","E07000036","Rural hamlet and isolated dwellings",118,93,53,40,0,4,1,3,20,19,1,1
"2011","Erewash","E07000036","Rural hamlet and isolated dwellings in a sparse setting",0,0,0,0,0,0,0,0,0,0,0,0
"2011","High Peak","E07000037","Total",38946,28059,13693,14366,229,4945,3836,1109,5231,4706,525,482
"2011","High Peak","E07000037","Urban (total)",26945,18651,8672,9979,137,3948,3026,922,3895,3522,373,314
"2011","High Peak","E07000037","Urban major conurbation",13125,9297,3953,5344,55,1997,1669,328,1614,1462,152,162
"2011","High Peak","E07000037","Urban minor conurbation",0,0,0,0,0,0,0,0,0,0,0,0
"2011","High Peak","E07000037","Urban city and town",13820,9354,4719,4635,82,1951,1357,594,2281,2060,221,152
"2011","High Peak","E07000037","Urban city and town in a sparse setting",0,0,0,0,0,0,0,0,0,0,0,0
"2011","High Peak","E07000037","Rural (total)",12001,9408,5021,4387,92,997,810,187,1336,1184,152,168
"2011","High Peak","E07000037","Rural town and fringe",6326,4829,2483,2346,71,604,524,80,743,671,72,79
"2011","High Peak","E07000037","Rural town and fringe in a sparse setting",0,0,0,0,0,0,0,0,0,0,0,0
"2011","High Peak","E07000037","Rural village",3286,2557,1472,1085,13,359,268,91,309,271,38,48
"2011","High Peak","E07000037","Rural village in a sparse setting",0,0,0,0,0,0,0,0,0,0,0,0
"2011","High Peak","E07000037","Rural hamlet and isolated dwellings",2389,2022,1066,956,8,34,18,16,284,242,42,41
"2011","High Peak","E07000037","Rural hamlet and isolated dwellings in a sparse setting",0,0,0,0,0,0,0,0,0,0,0,0
"2011","North East Derbyshire","E07000038","Total",43070,30531,16471,14060,168,8781,7817,964,3183,2800,383,407
"2011","North East Derbyshire","E07000038","Urban (total)",34545,24537,13054,11483,156,7041,6302,739,2519,2221,298,292
"2011","North East Derbyshire","E07000038","Urban major conurbation",0,0,0,0,0,0,0,0,0,0,0,0
"2011","North East Derbyshire","E07000038","Urban minor conurbation",16030,12222,6357,5865,91,2567,2120,447,1024,893,131,126
"2011","North East Derbyshire","E07000038","Urban city and town",18515,12315,6697,5618,65,4474,4182,292,1495,1328,167,166
"2011","North East Derbyshire","E07000038","Urban city and town in a sparse setting",0,0,0,0,0,0,0,0,0,0,0,0
"2011","North East Derbyshire","E07000038","Rural (total)",8525,5994,3417,2577,12,1740,1515,225,664,579,85,115
"2011","North East Derbyshire","E07000038","Rural town and fringe",2717,1723,872,851,5,780,733,47,182,162,20,27
"2011","North East Derbyshire","E07000038","Rural town and fringe in a sparse setting",0,0,0,0,0,0,0,0,0,0,0,0
"2011","North East Derbyshire","E07000038","Rural village",4133,2901,1673,1228,4,870,702,168,299,264,35,59
"2011","North East Derbyshire","E07000038","Rural village in a sparse setting",0,0,0,0,0,0,0,0,0,0,0,0
"2011","North East Derbyshire","E07000038","Rural hamlet and isolated dwellings",1675,1370,872,498,3,90,80,10,183,153,30,29
"2011","North East Derbyshire","E07000038","Rural hamlet and isolated dwellings in a sparse setting",0,0,0,0,0,0,0,0,0,0,0,0
"2011","South Derbyshire","E07000039","Total",38992,29416,13237,16179,131,3877,2984,893,5087,4603,484,481
"2011","South Derbyshire","E07000039","Urban (total)",22153,16116,6714,9402,79,2737,2093,644,2998,2755,243,223
"2011","South Derbyshire","E07000039","Urban major conurbation",0,0,0,0,0,0,0,0,0,0,0,0
"2011","South Derbyshire","E07000039","Urban minor conurbation",0,0,0,0,0,0,0,0,0,0,0,0
"2011","South Derbyshire","E07000039","Urban city and town",22153,16116,6714,9402,79,2737,2093,644,2998,2755,243,223
"2011","South Derbyshire","E07000039","Urban city and town in a sparse setting",0,0,0,0,0,0,0,0,0,0,0,0
"2011","South Derbyshire","E07000039","Rural (total)",16839,13300,6523,6777,52,1140,891,249,2089,1848,241,258
"2011","South Derbyshire","E07000039","Rural town and fringe",10890,8546,3918,4628,37,793,630,163,1374,1220,154,140
"2011","South Derbyshire","E07000039","Rural town and fringe in a sparse setting",0,0,0,0,0,0,0,0,0,0,0,0
"2011","South Derbyshire","E07000039","Rural village",4115,3295,1796,1499,12,313,245,68,428,371,57,67
"2011","South Derbyshire","E07000039","Rural village in a sparse setting",0,0,0,0,0,0,0,0,0,0,0,0
"2011","South Derbyshire","E07000039","Rural hamlet and isolated dwellings",1834,1459,809,650,3,34,16,18,287,257,30,51
"2011","South Derbyshire","E07000039","Rural hamlet and isolated dwellings in a sparse setting",0,0,0,0,0,0,0,0,0,0,0,0
"2011","Blaby","E07000129","Total",38686,31309,14745,16564,247,2948,721,2227,3876,3471,405,306
"2011","Blaby","E07000129","Urban (total)",31007,25055,11659,13396,181,2269,535,1734,3256,2945,311,246
"2011","Blaby","E07000129","Urban major conurbation",0,0,0,0,0,0,0,0,0,0,0,0
"2011","Blaby","E07000129","Urban minor conurbation",0,0,0,0,0,0,0,0,0,0,0,0
"2011","Blaby","E07000129","Urban city and town",31007,25055,11659,13396,181,2269,535,1734,3256,2945,311,246
"2011","Blaby","E07000129","Urban city and town in a sparse setting",0,0,0,0,0,0,0,0,0,0,0,0
"2011","Blaby","E07000129","Rural (total)",7679,6254,3086,3168,66,679,186,493,620,526,94,60
"2011","Blaby","E07000129","Rural town and fringe",6690,5481,2649,2832,63,574,156,418,528,447,81,44
"2011","Blaby","E07000129","Rural town and fringe in a sparse setting",0,0,0,0,0,0,0,0,0,0,0,0
"2011","Blaby","E07000129","Rural village",989,773,437,336,3,105,30,75,92,79,13,16
"2011","Blaby","E07000129","Rural village in a sparse setting",0,0,0,0,0,0,0,0,0,0,0,0
"2011","Blaby","E07000129","Rural hamlet and isolated dwellings",0,0,0,0,0,0,0,0,0,0,0,0
"2011","Blaby","E07000129","Rural hamlet and isolated dwellings in a sparse setting",0,0,0,0,0,0,0,0,0,0,0,0
"2011","Charnwood","E07000130","Total",66516,47961,23729,24232,539,7851,5306,2545,9396,8590,806,769
"2011","Charnwood","E07000130","Urban (total)",56694,40016,19539,20477,498,7217,4765,2452,8346,7666,680,617
"2011","Charnwood","E07000130","Urban major conurbation",0,0,0,0,0,0,0,0,0,0,0,0
"2011","Charnwood","E07000130","Urban minor conurbation",0,0,0,0,0,0,0,0,0,0,0,0
"2011","Charnwood","E07000130","Urban city and town",56694,40016,19539,20477,498,7217,4765,2452,8346,7666,680,617
"2011","Charnwood","E07000130","Urban city and town in a sparse setting",0,0,0,0,0,0,0,0,0,0,0,0
"2011","Charnwood","E07000130","Rural (total)",9822,7945,4190,3755,41,634,541,93,1050,924,126,152
"2011","Charnwood","E07000130","Rural town and fringe",5777,4553,2298,2255,28,503,433,70,616,560,56,77
"2011","Charnwood","E07000130","Rural town and fringe in a sparse setting",0,0,0,0,0,0,0,0,0,0,0,0
"2011","Charnwood","E07000130","Rural village",3529,2964,1635,1329,11,124,101,23,360,300,60,70
"2011","Charnwood","E07000130","Rural village in a sparse setting",0,0,0,0,0,0,0,0,0,0,0,0
"2011","Charnwood","E07000130","Rural hamlet and isolated dwellings",516,428,257,171,2,7,7,0,74,64,10,5
"2011","Charnwood","E07000130","Rural hamlet and isolated dwellings in a sparse setting",0,0,0,0,0,0,0,0,0,0,0,0
"2011","Harborough","E07000131","Total",34898,27238,13389,13849,414,2923,481,2442,3922,3540,382,401
"2011","Harborough","E07000131","Urban (total)",11874,8912,4473,4439,214,1092,156,936,1539,1413,126,117
"2011","Harborough","E07000131","Urban major conurbation",0,0,0,0,0,0,0,0,0,0,0,0
"2011","Harborough","E07000131","Urban minor conurbation",0,0,0,0,0,0,0,0,0,0,0,0
"2011","Harborough","E07000131","Urban city and town",11874,8912,4473,4439,214,1092,156,936,1539,1413,126,117
"2011","Harborough","E07000131","Urban city and town in a sparse setting",0,0,0,0,0,0,0,0,0,0,0,0
"2011","Harborough","E07000131","Rural (total)",23024,18326,8916,9410,200,1831,325,1506,2383,2127,256,284
"2011","Harborough","E07000131","Rural town and fringe",13518,10774,4963,5811,145,1195,192,1003,1280,1150,130,124
"2011","Harborough","E07000131","Rural town and fringe in a sparse setting",0,0,0,0,0,0,0,0,0,0,0,0
"2011","Harborough","E07000131","Rural village",7947,6394,3300,3094,48,546,104,442,847,762,85,112
"2011","Harborough","E07000131","Rural village in a sparse setting",0,0,0,0,0,0,0,0,0,0,0,0
"2011","Harborough","E07000131","Rural hamlet and isolated dwellings",1559,1158,653,505,7,90,29,61,256,215,41,48
"2011","Harborough","E07000131","Rural hamlet and isolated dwellings in a sparse setting",0,0,0,0,0,0,0,0,0,0,0,0
"2011","Hinckley and Bosworth","E07000132","Total",45377,34826,16859,17967,267,4685,3238,1447,5156,4657,499,443
"2011","Hinckley and Bosworth","E07000132","Urban (total)",31025,23384,10877,12507,201,3330,2204,1126,3829,3515,314,281
"2011","Hinckley and Bosworth","E07000132","Urban major conurbation",0,0,0,0,0,0,0,0,0,0,0,0
"2011","Hinckley and Bosworth","E07000132","Urban minor conurbation",0,0,0,0,0,0,0,0,0,0,0,0
"2011","Hinckley and Bosworth","E07000132","Urban city and town",31025,23384,10877,12507,201,3330,2204,1126,3829,3515,314,281
"2011","Hinckley and Bosworth","E07000132","Urban city and town in a sparse setting",0,0,0,0,0,0,0,0,0,0,0,0
"2011","Hinckley and Bosworth","E07000132","Rural (total)",14352,11442,5982,5460,66,1355,1034,321,1327,1142,185,162
"2011","Hinckley and Bosworth","E07000132","Rural town and fringe",9212,7313,3835,3478,41,969,750,219,787,699,88,102
"2011","Hinckley and Bosworth","E07000132","Rural town and fringe in a sparse setting",0,0,0,0,0,0,0,0,0,0,0,0
"2011","Hinckley and Bosworth","E07000132","Rural village",3742,3003,1514,1489,21,356,264,92,323,247,76,39
"2011","Hinckley and Bosworth","E07000132","Rural village in a sparse setting",0,0,0,0,0,0,0,0,0,0,0,0
"2011","Hinckley and Bosworth","E07000132","Rural hamlet and isolated dwellings",1398,1126,633,493,4,30,20,10,217,196,21,21
"2011","Hinckley and Bosworth","E07000132","Rural hamlet and isolated dwellings in a sparse setting",0,0,0,0,0,0,0,0,0,0,0,0
"2011","Melton","E07000133","Total",21490,15498,7728,7770,198,2402,1814,588,3054,2738,316,338
"2011","Melton","E07000133","Urban (total)",11613,8237,3988,4249,128,1614,1176,438,1533,1378,155,101
"2011","Melton","E07000133","Urban major conurbation",0,0,0,0,0,0,0,0,0,0,0,0
"2011","Melton","E07000133","Urban minor conurbation",0,0,0,0,0,0,0,0,0,0,0,0
"2011","Melton","E07000133","Urban city and town",11613,8237,3988,4249,128,1614,1176,438,1533,1378,155,101
"2011","Melton","E07000133","Urban city and town in a sparse setting",0,0,0,0,0,0,0,0,0,0,0,0
"2011","Melton","E07000133","Rural (total)",9877,7261,3740,3521,70,788,638,150,1521,1360,161,237
"2011","Melton","E07000133","Rural town and fringe",2340,1771,891,880,36,280,239,41,223,202,21,30
"2011","Melton","E07000133","Rural town and fringe in a sparse setting",0,0,0,0,0,0,0,0,0,0,0,0
"2011","Melton","E07000133","Rural village",6429,4728,2439,2289,32,459,361,98,1042,923,119,168
"2011","Melton","E07000133","Rural village in a sparse setting",0,0,0,0,0,0,0,0,0,0,0,0
"2011","Melton","E07000133","Rural hamlet and isolated dwellings",1108,762,410,352,2,49,38,11,256,235,21,39
"2011","Melton","E07000133","Rural hamlet and isolated dwellings in a sparse setting",0,0,0,0,0,0,0,0,0,0,0,0
"2011","North West Leicestershire","E07000134","Total",39128,28360,13581,14779,302,5598,4181,1417,4411,3997,414,457
"2011","North West Leicestershire","E07000134","Urban (total)",21542,15459,7202,8257,227,3318,2201,1117,2301,2089,212,237
"2011","North West Leicestershire","E07000134","Urban major conurbation",0,0,0,0,0,0,0,0,0,0,0,0
"2011","North West Leicestershire","E07000134","Urban minor conurbation",0,0,0,0,0,0,0,0,0,0,0,0
"2011","North West Leicestershire","E07000134","Urban city and town",21542,15459,7202,8257,227,3318,2201,1117,2301,2089,212,237
"2011","North West Leicestershire","E07000134","Urban city and town in a sparse setting",0,0,0,0,0,0,0,0,0,0,0,0
"2011","North West Leicestershire","E07000134","Rural (total)",17586,12901,6379,6522,75,2280,1980,300,2110,1908,202,220
"2011","North West Leicestershire","E07000134","Rural town and fringe",10706,7563,3664,3899,50,1600,1400,200,1374,1256,118,119
"2011","North West Leicestershire","E07000134","Rural town and fringe in a sparse setting",0,0,0,0,0,0,0,0,0,0,0,0
"2011","North West Leicestershire","E07000134","Rural village",6001,4702,2385,2317,24,558,482,76,636,562,74,81
"2011","North West Leicestershire","E07000134","Rural village in a sparse setting",0,0,0,0,0,0,0,0,0,0,0,0
"2011","North West Leicestershire","E07000134","Rural hamlet and isolated dwellings",879,636,330,306,1,122,98,24,100,90,10,20
"2011","North West Leicestershire","E07000134","Rural hamlet and isolated dwellings in a sparse setting",0,0,0,0,0,0,0,0,0,0,0,0
"2011","Oadby and Wigston","E07000135","Total",21339,17239,9069,8170,161,1610,1147,463,2117,1922,195,212
"2011","Oadby and Wigston","E07000135","Urban (total)",21339,17239,9069,8170,161,1610,1147,463,2117,1922,195,212
"2011","Oadby and Wigston","E07000135","Urban major conurbation",0,0,0,0,0,0,0,0,0,0,0,0
"2011","Oadby and Wigston","E07000135","Urban minor conurbation",0,0,0,0,0,0,0,0,0,0,0,0
"2011","Oadby and Wigston","E07000135","Urban city and town",21339,17239,9069,8170,161,1610,1147,463,2117,1922,195,212
"2011","Oadby and Wigston","E07000135","Urban city and town in a sparse setting",0,0,0,0,0,0,0,0,0,0,0,0
"2011","Oadby and Wigston","E07000135","Rural (total)",0,0,0,0,0,0,0,0,0,0,0,0
"2011","Oadby and Wigston","E07000135","Rural town and fringe",0,0,0,0,0,0,0,0,0,0,0,0
"2011","Oadby and Wigston","E07000135","Rural town and fringe in a sparse setting",0,0,0,0,0,0,0,0,0,0,0,0
"2011","Oadby and Wigston","E07000135","Rural village",0,0,0,0,0,0,0,0,0,0,0,0
"2011","Oadby and Wigston","E07000135","Rural village in a sparse setting",0,0,0,0,0,0,0,0,0,0,0,0
"2011","Oadby and Wigston","E07000135","Rural hamlet and isolated dwellings",0,0,0,0,0,0,0,0,0,0,0,0
"2011","Oadby and Wigston","E07000135","Rural hamlet and isolated dwellings in a sparse setting",0,0,0,0,0,0,0,0,0,0,0,0
"2011","Boston","E07000136","Total",27291,17430,9243,8187,230,4965,1671,3294,4291,3908,383,375
"2011","Boston","E07000136","Urban (total)",17622,10534,5493,5041,160,3328,1165,2163,3370,3131,239,230
"2011","Boston","E07000136","Urban major conurbation",0,0,0,0,0,0,0,0,0,0,0,0
"2011","Boston","E07000136","Urban minor conurbation",0,0,0,0,0,0,0,0,0,0,0,0
"2011","Boston","E07000136","Urban city and town",17622,10534,5493,5041,160,3328,1165,2163,3370,3131,239,230
"2011","Boston","E07000136","Urban city and town in a sparse setting",0,0,0,0,0,0,0,0,0,0,0,0
"2011","Boston","E07000136","Rural (total)",9669,6896,3750,3146,70,1637,506,1131,921,777,144,145
"2011","Boston","E07000136","Rural town and fringe",3704,2416,1225,1191,31,796,228,568,424,390,34,37
"2011","Boston","E07000136","Rural town and fringe in a sparse setting",0,0,0,0,0,0,0,0,0,0,0,0
"2011","Boston","E07000136","Rural village",2126,1499,831,668,27,435,129,306,136,115,21,29
"2011","Boston","E07000136","Rural village in a sparse setting",570,434,255,179,3,99,22,77,33,30,3,1
"2011","Boston","E07000136","Rural hamlet and isolated dwellings",2934,2310,1305,1005,8,264,114,150,285,208,77,67
"2011","Boston","E07000136","Rural hamlet and isolated dwellings in a sparse setting",335,237,134,103,1,43,13,30,43,34,9,11
"2011","East Lindsey","E07000137","Total",60890,42137,25826,16311,482,6705,1605,5100,10554,9334,1220,1012
"2011","East Lindsey","E07000137","Urban (total)",25038,15603,9917,5686,233,3603,846,2757,5297,4949,348,302
"2011","East Lindsey","E07000137","Urban major conurbation",0,0,0,0,0,0,0,0,0,0,0,0
"2011","East Lindsey","E07000137","Urban minor conurbation",0,0,0,0,0,0,0,0,0,0,0,0
"2011","East Lindsey","E07000137","Urban city and town",19157,11410,6828,4582,201,2953,755,2198,4371,4085,286,222
"2011","East Lindsey","E07000137","Urban city and town in a sparse setting",5881,4193,3089,1104,32,650,91,559,926,864,62,80
"2011","East Lindsey","E07000137","Rural (total)",35852,26534,15909,10625,249,3102,759,2343,5257,4385,872,710
"2011","East Lindsey","E07000137","Rural town and fringe",11669,8268,4761,3507,117,1279,308,971,1839,1497,342,166
"2011","East Lindsey","E07000137","Rural town and fringe in a sparse setting",2916,1706,971,735,23,494,121,373,639,570,69,54
"2011","East Lindsey","E07000137","Rural village",8219,6524,3877,2647,42,511,120,391,994,788,206,148
"2011","East Lindsey","E07000137","Rural village in a sparse setting",4365,3451,2200,1251,23,359,89,270,456,385,71,76
"2011","East Lindsey","E07000137","Rural hamlet and isolated dwellings",5744,4435,2783,1652,27,278,65,213,835,718,117,169
"2011","East Lindsey","E07000137","Rural hamlet and isolated dwellings in a sparse setting",2939,2150,1317,833,17,181,56,125,494,427,67,97
"2011","Lincoln","E07000138","Total",39825,21932,9717,12215,220,8729,7381,1348,8345,7709,636,599
"2011","Lincoln","E07000138","Urban (total)",39825,21932,9717,12215,220,8729,7381,1348,8345,7709,636,599
"2011","Lincoln","E07000138","Urban major conurbation",0,0,0,0,0,0,0,0,0,0,0,0
"2011","Lincoln","E07000138","Urban minor conurbation",0,0,0,0,0,0,0,0,0,0,0,0
"2011","Lincoln","E07000138","Urban city and town",39825,21932,9717,12215,220,8729,7381,1348,8345,7709,636,599
"2011","Lincoln","E07000138","Urban city and town in a sparse setting",0,0,0,0,0,0,0,0,0,0,0,0
"2011","Lincoln","E07000138","Rural (total)",0,0,0,0,0,0,0,0,0,0,0,0
"2011","Lincoln","E07000138","Rural town and fringe",0,0,0,0,0,0,0,0,0,0,0,0
"2011","Lincoln","E07000138","Rural town and fringe in a sparse setting",0,0,0,0,0,0,0,0,0,0,0,0
"2011","Lincoln","E07000138","Rural village",0,0,0,0,0,0,0,0,0,0,0,0
"2011","Lincoln","E07000138","Rural village in a sparse setting",0,0,0,0,0,0,0,0,0,0,0,0
"2011","Lincoln","E07000138","Rural hamlet and isolated dwellings",0,0,0,0,0,0,0,0,0,0,0,0
"2011","Lincoln","E07000138","Rural hamlet and isolated dwellings in a sparse setting",0,0,0,0,0,0,0,0,0,0,0,0
"2011","North Kesteven","E07000139","Total",45972,34187,17115,17072,221,4694,3693,1001,6184,4906,1278,686
"2011","North Kesteven","E07000139","Urban (total)",16326,11980,5955,6025,122,1720,1122,598,2331,1856,475,173
"2011","North Kesteven","E07000139","Urban major conurbation",0,0,0,0,0,0,0,0,0,0,0,0
"2011","North Kesteven","E07000139","Urban minor conurbation",0,0,0,0,0,0,0,0,0,0,0,0
"2011","North Kesteven","E07000139","Urban city and town",16326,11980,5955,6025,122,1720,1122,598,2331,1856,475,173
"2011","North Kesteven","E07000139","Urban city and town in a sparse setting",0,0,0,0,0,0,0,0,0,0,0,0
"2011","North Kesteven","E07000139","Rural (total)",29646,22207,11160,11047,99,2974,2571,403,3853,3050,803,513
"2011","North Kesteven","E07000139","Rural town and fringe",17834,13822,6881,6941,62,1687,1420,267,2020,1776,244,243
"2011","North Kesteven","E07000139","Rural town and fringe in a sparse setting",0,0,0,0,0,0,0,0,0,0,0,0
"2011","North Kesteven","E07000139","Rural village",9242,6501,3270,3231,29,1015,896,119,1502,980,522,195
"2011","North Kesteven","E07000139","Rural village in a sparse setting",0,0,0,0,0,0,0,0,0,0,0,0
"2011","North Kesteven","E07000139","Rural hamlet and isolated dwellings",2570,1884,1009,875,8,272,255,17,331,294,37,75
"2011","North Kesteven","E07000139","Rural hamlet and isolated dwellings in a sparse setting",0,0,0,0,0,0,0,0,0,0,0,0
"2011","South Holland","E07000140","Total",37264,27035,14623,12412,260,4728,3828,900,4714,4173,541,527
"2011","South Holland","E07000140","Urban (total)",13356,9056,4771,4285,169,1755,1314,441,2194,2008,186,182
"2011","South Holland","E07000140","Urban major conurbation",0,0,0,0,0,0,0,0,0,0,0,0
"2011","South Holland","E07000140","Urban minor conurbation",0,0,0,0,0,0,0,0,0,0,0,0
"2011","South Holland","E07000140","Urban city and town",13356,9056,4771,4285,169,1755,1314,441,2194,2008,186,182
"2011","South Holland","E07000140","Urban city and town in a sparse setting",0,0,0,0,0,0,0,0,0,0,0,0
"2011","South Holland","E07000140","Rural (total)",23908,17979,9852,8127,91,2973,2514,459,2520,2165,355,345
"2011","South Holland","E07000140","Rural town and fringe",10664,7708,4321,3387,53,1433,1131,302,1309,1189,120,161
"2011","South Holland","E07000140","Rural town and fringe in a sparse setting",0,0,0,0,0,0,0,0,0,0,0,0
"2011","South Holland","E07000140","Rural village",8701,6806,3636,3170,32,1086,986,100,666,566,100,111
"2011","South Holland","E07000140","Rural village in a sparse setting",0,0,0,0,0,0,0,0,0,0,0,0
"2011","South Holland","E07000140","Rural hamlet and isolated dwellings",4543,3465,1895,1570,6,454,397,57,545,410,135,73
"2011","South Holland","E07000140","Rural hamlet and isolated dwellings in a sparse setting",0,0,0,0,0,0,0,0,0,0,0,0
"2011","South Kesteven","E07000141","Total",57344,39809,19258,20551,502,7701,5949,1752,8389,7653,736,943
"2011","South Kesteven","E07000141","Urban (total)",39232,26152,12279,13873,399,5868,4505,1363,6291,5806,485,522
"2011","South Kesteven","E07000141","Urban major conurbation",0,0,0,0,0,0,0,0,0,0,0,0
"2011","South Kesteven","E07000141","Urban minor conurbation",0,0,0,0,0,0,0,0,0,0,0,0
"2011","South Kesteven","E07000141","Urban city and town",39232,26152,12279,13873,399,5868,4505,1363,6291,5806,485,522
"2011","South Kesteven","E07000141","Urban city and town in a sparse setting",0,0,0,0,0,0,0,0,0,0,0,0
"2011","South Kesteven","E07000141","Rural (total)",18112,13657,6979,6678,103,1833,1444,389,2098,1847,251,421
"2011","South Kesteven","E07000141","Rural town and fringe",6272,4884,2301,2583,31,655,463,192,623,552,71,79
"2011","South Kesteven","E07000141","Rural town and fringe in a sparse setting",0,0,0,0,0,0,0,0,0,0,0,0
"2011","South Kesteven","E07000141","Rural village",10058,7581,4043,3538,55,1011,862,149,1136,998,138,275
"2011","South Kesteven","E07000141","Rural village in a sparse setting",0,0,0,0,0,0,0,0,0,0,0,0
"2011","South Kesteven","E07000141","Rural hamlet and isolated dwellings",1782,1192,635,557,17,167,119,48,339,297,42,67
"2011","South Kesteven","E07000141","Rural hamlet and isolated dwellings in a sparse setting",0,0,0,0,0,0,0,0,0,0,0,0
"2011","West Lindsey","E07000142","Total",38385,27859,14672,13187,365,4246,911,3335,5253,4594,659,662
"2011","West Lindsey","E07000142","Urban (total)",9455,5558,2584,2974,111,2022,547,1475,1657,1524,133,107
"2011","West Lindsey","E07000142","Urban major conurbation",0,0,0,0,0,0,0,0,0,0,0,0
"2011","West Lindsey","E07000142","Urban minor conurbation",0,0,0,0,0,0,0,0,0,0,0,0
"2011","West Lindsey","E07000142","Urban city and town",9455,5558,2584,2974,111,2022,547,1475,1657,1524,133,107
"2011","West Lindsey","E07000142","Urban city and town in a sparse setting",0,0,0,0,0,0,0,0,0,0,0,0
"2011","West Lindsey","E07000142","Rural (total)",28930,22301,12088,10213,254,2224,364,1860,3596,3070,526,555
"2011","West Lindsey","E07000142","Rural town and fringe",14011,11031,6188,4843,146,1223,177,1046,1411,1237,174,200
"2011","West Lindsey","E07000142","Rural town and fringe in a sparse setting",0,0,0,0,0,0,0,0,0,0,0,0
"2011","West Lindsey","E07000142","Rural village",12079,9212,4780,4432,91,857,158,699,1676,1381,295,243
"2011","West Lindsey","E07000142","Rural village in a sparse setting",0,0,0,0,0,0,0,0,0,0,0,0
"2011","West Lindsey","E07000142","Rural hamlet and isolated dwellings",2840,2058,1120,938,17,144,29,115,509,452,57,112
"2011","West Lindsey","E07000142","Rural hamlet and isolated dwellings in a sparse setting",0,0,0,0,0,0,0,0,0,0,0,0
"2011","Corby","E07000150","Total",25215,15669,5917,9752,94,5278,4463,815,3839,3582,257,335
"2011","Corby","E07000150","Urban (total)",23326,14183,5152,9031,79,5092,4369,723,3670,3436,234,302
"2011","Corby","E07000150","Urban major conurbation",0,0,0,0,0,0,0,0,0,0,0,0
"2011","Corby","E07000150","Urban minor conurbation",0,0,0,0,0,0,0,0,0,0,0,0
"2011","Corby","E07000150","Urban city and town",23326,14183,5152,9031,79,5092,4369,723,3670,3436,234,302
"2011","Corby","E07000150","Urban city and town in a sparse setting",0,0,0,0,0,0,0,0,0,0,0,0
"2011","Corby","E07000150","Rural (total)",1889,1486,765,721,15,186,94,92,169,146,23,33
"2011","Corby","E07000150","Rural town and fringe",585,475,264,211,0,60,45,15,37,28,9,13
"2011","Corby","E07000150","Rural town and fringe in a sparse setting",0,0,0,0,0,0,0,0,0,0,0,0
"2011","Corby","E07000150","Rural village",1196,938,444,494,12,102,26,76,127,113,14,17
"2011","Corby","E07000150","Rural village in a sparse setting",0,0,0,0,0,0,0,0,0,0,0,0
"2011","Corby","E07000150","Rural hamlet and isolated dwellings",108,73,57,16,3,24,23,1,5,5,0,3
"2011","Corby","E07000150","Rural hamlet and isolated dwellings in a sparse setting",0,0,0,0,0,0,0,0,0,0,0,0
"2011","Daventry","E07000151","Total",31647,22688,10533,12155,271,4412,1282,3130,3832,3471,361,444
"2011","Daventry","E07000151","Urban (total)",11734,7588,3172,4416,132,2292,678,1614,1602,1460,142,120
"2011","Daventry","E07000151","Urban major conurbation",0,0,0,0,0,0,0,0,0,0,0,0
"2011","Daventry","E07000151","Urban minor conurbation",0,0,0,0,0,0,0,0,0,0,0,0
"2011","Daventry","E07000151","Urban city and town",11734,7588,3172,4416,132,2292,678,1614,1602,1460,142,120
"2011","Daventry","E07000151","Urban city and town in a sparse setting",0,0,0,0,0,0,0,0,0,0,0,0
"2011","Daventry","E07000151","Rural (total)",19913,15100,7361,7739,139,2120,604,1516,2230,2011,219,324
"2011","Daventry","E07000151","Rural town and fringe",9542,7023,3060,3963,93,1263,356,907,1051,954,97,112
"2011","Daventry","E07000151","Rural town and fringe in a sparse setting",0,0,0,0,0,0,0,0,0,0,0,0
"2011","Daventry","E07000151","Rural village",8463,6688,3608,3080,35,696,214,482,879,787,92,165
"2011","Daventry","E07000151","Rural village in a sparse setting",0,0,0,0,0,0,0,0,0,0,0,0
"2011","Daventry","E07000151","Rural hamlet and isolated dwellings",1908,1389,693,696,11,161,34,127,300,270,30,47
"2011","Daventry","E07000151","Rural hamlet and isolated dwellings in a sparse setting",0,0,0,0,0,0,0,0,0,0,0,0
"2011","East Northamptonshire","E07000152","Total",35662,25837,11419,14418,175,4737,805,3932,4471,4032,439,442
"2011","East Northamptonshire","E07000152","Urban (total)",15334,11232,4683,6549,73,2038,366,1672,1852,1684,168,139
"2011","East Northamptonshire","E07000152","Urban major conurbation",0,0,0,0,0,0,0,0,0,0,0,0
"2011","East Northamptonshire","E07000152","Urban minor conurbation",0,0,0,0,0,0,0,0,0,0,0,0
"2011","East Northamptonshire","E07000152","Urban city and town",15334,11232,4683,6549,73,2038,366,1672,1852,1684,168,139
"2011","East Northamptonshire","E07000152","Urban city and town in a sparse setting",0,0,0,0,0,0,0,0,0,0,0,0
"2011","East Northamptonshire","E07000152","Rural (total)",20328,14605,6736,7869,102,2699,439,2260,2619,2348,271,303
"2011","East Northamptonshire","E07000152","Rural town and fringe",13890,10062,4277,5785,54,1866,321,1545,1749,1564,185,159
"2011","East Northamptonshire","E07000152","Rural town and fringe in a sparse setting",0,0,0,0,0,0,0,0,0,0,0,0
"2011","East Northamptonshire","E07000152","Rural village",5545,3892,2111,1781,46,809,116,693,676,612,64,122
"2011","East Northamptonshire","E07000152","Rural village in a sparse setting",0,0,0,0,0,0,0,0,0,0,0,0
"2011","East Northamptonshire","E07000152","Rural hamlet and isolated dwellings",893,651,348,303,2,24,2,22,194,172,22,22
"2011","East Northamptonshire","E07000152","Rural hamlet and isolated dwellings in a sparse setting",0,0,0,0,0,0,0,0,0,0,0,0
"2011","Kettering","E07000153","Total",39701,27562,12070,15492,342,5187,3506,1681,6048,5533,515,562
"2011","Kettering","E07000153","Urban (total)",31632,21712,9386,12326,271,4258,2848,1410,4977,4556,421,414
"2011","Kettering","E07000153","Urban major conurbation",0,0,0,0,0,0,0,0,0,0,0,0
"2011","Kettering","E07000153","Urban minor conurbation",0,0,0,0,0,0,0,0,0,0,0,0
"2011","Kettering","E07000153","Urban city and town",31632,21712,9386,12326,271,4258,2848,1410,4977,4556,421,414
"2011","Kettering","E07000153","Urban city and town in a sparse setting",0,0,0,0,0,0,0,0,0,0,0,0
"2011","Kettering","E07000153","Rural (total)",8069,5850,2684,3166,71,929,658,271,1071,977,94,148
"2011","Kettering","E07000153","Rural town and fringe",5769,4169,1758,2411,66,715,466,249,741,675,66,78
"2011","Kettering","E07000153","Rural town and fringe in a sparse setting",0,0,0,0,0,0,0,0,0,0,0,0
"2011","Kettering","E07000153","Rural village",1556,1134,622,512,4,140,124,16,230,210,20,48
"2011","Kettering","E07000153","Rural village in a sparse setting",0,0,0,0,0,0,0,0,0,0,0,0
"2011","Kettering","E07000153","Rural hamlet and isolated dwellings",744,547,304,243,1,74,68,6,100,92,8,22
"2011","Kettering","E07000153","Rural hamlet and isolated dwellings in a sparse setting",0,0,0,0,0,0,0,0,0,0,0,0
"2011","Northampton","E07000154","Total",88731,55622,22307,33315,1134,15113,11319,3794,15817,14657,1160,1045
"2011","Northampton","E07000154","Urban (total)",88310,55307,22154,33153,1117,15088,11306,3782,15760,14606,1154,1038
"2011","Northampton","E07000154","Urban major conurbation",0,0,0,0,0,0,0,0,0,0,0,0
"2011","Northampton","E07000154","Urban minor conurbation",0,0,0,0,0,0,0,0,0,0,0,0
"2011","Northampton","E07000154","Urban city and town",88310,55307,22154,33153,1117,15088,11306,3782,15760,14606,1154,1038
"2011","Northampton","E07000154","Urban city and town in a sparse setting",0,0,0,0,0,0,0,0,0,0,0,0
"2011","Northampton","E07000154","Rural (total)",421,315,153,162,17,25,13,12,57,51,6,7
"2011","Northampton","E07000154","Rural town and fringe",144,71,15,56,16,12,0,12,43,41,2,2
"2011","Northampton","E07000154","Rural town and fringe in a sparse setting",0,0,0,0,0,0,0,0,0,0,0,0
"2011","Northampton","E07000154","Rural village",277,244,138,106,1,13,13,0,14,10,4,5
"2011","Northampton","E07000154","Rural village in a sparse setting",0,0,0,0,0,0,0,0,0,0,0,0
"2011","Northampton","E07000154","Rural hamlet and isolated dwellings",0,0,0,0,0,0,0,0,0,0,0,0
"2011","Northampton","E07000154","Rural hamlet and isolated dwellings in a sparse setting",0,0,0,0,0,0,0,0,0,0,0,0
"2011","South Northamptonshire","E07000155","Total",34717,26485,12029,14456,357,3505,901,2604,3840,3439,401,530
"2011","South Northamptonshire","E07000155","Urban (total)",5400,4182,1553,2629,36,461,67,394,674,604,70,47
"2011","South Northamptonshire","E07000155","Urban major conurbation",0,0,0,0,0,0,0,0,0,0,0,0
"2011","South Northamptonshire","E07000155","Urban minor conurbation",0,0,0,0,0,0,0,0,0,0,0,0
"2011","South Northamptonshire","E07000155","Urban city and town",5400,4182,1553,2629,36,461,67,394,674,604,70,47
"2011","South Northamptonshire","E07000155","Urban city and town in a sparse setting",0,0,0,0,0,0,0,0,0,0,0,0
"2011","South Northamptonshire","E07000155","Rural (total)",29317,22303,10476,11827,321,3044,834,2210,3166,2835,331,483
"2011","South Northamptonshire","E07000155","Rural town and fringe",16669,12711,5578,7133,281,1825,511,1314,1665,1510,155,187
"2011","South Northamptonshire","E07000155","Rural town and fringe in a sparse setting",0,0,0,0,0,0,0,0,0,0,0,0
"2011","South Northamptonshire","E07000155","Rural village",11295,8675,4408,4267,35,1076,280,796,1275,1123,152,234
"2011","South Northamptonshire","E07000155","Rural village in a sparse setting",0,0,0,0,0,0,0,0,0,0,0,0
"2011","South Northamptonshire","E07000155","Rural hamlet and isolated dwellings",1353,917,490,427,5,143,43,100,226,202,24,62
"2011","South Northamptonshire","E07000155","Rural hamlet and isolated dwellings in a sparse setting",0,0,0,0,0,0,0,0,0,0,0,0
"2011","Wellingborough","E07000156","Total",32057,21286,9584,11702,315,5676,1720,3956,4360,3965,395,420
"2011","Wellingborough","E07000156","Urban (total)",21371,13204,5625,7579,251,4468,1383,3085,3185,2916,269,263
"2011","Wellingborough","E07000156","Urban major conurbation",0,0,0,0,0,0,0,0,0,0,0,0
"2011","Wellingborough","E07000156","Urban minor conurbation",0,0,0,0,0,0,0,0,0,0,0,0
"2011","Wellingborough","E07000156","Urban city and town",21371,13204,5625,7579,251,4468,1383,3085,3185,2916,269,263
"2011","Wellingborough","E07000156","Urban city and town in a sparse setting",0,0,0,0,0,0,0,0,0,0,0,0
"2011","Wellingborough","E07000156","Rural (total)",10686,8082,3959,4123,64,1208,337,871,1175,1049,126,157
"2011","Wellingborough","E07000156","Rural town and fringe",8695,6534,3123,3411,59,1003,289,714,982,881,101,117
"2011","Wellingborough","E07000156","Rural town and fringe in a sparse setting",0,0,0,0,0,0,0,0,0,0,0,0
"2011","Wellingborough","E07000156","Rural village",1924,1500,810,690,5,198,46,152,186,164,22,35
"2011","Wellingborough","E07000156","Rural village in a sparse setting",0,0,0,0,0,0,0,0,0,0,0,0
"2011","Wellingborough","E07000156","Rural hamlet and isolated dwellings",67,48,26,22,0,7,2,5,7,4,3,5
"2011","Wellingborough","E07000156","Rural hamlet and isolated dwellings in a sparse setting",0,0,0,0,0,0,0,0,0,0,0,0
"2011","Ashfield","E07000170","Total",50931,35261,16952,18309,235,8258,6460,1798,6504,5908,596,673
"2011","Ashfield","E07000170","Urban (total)",50629,34994,16833,18161,235,8247,6455,1792,6480,5891,589,673
"2011","Ashfield","E07000170","Urban major conurbation",0,0,0,0,0,0,0,0,0,0,0,0
"2011","Ashfield","E07000170","Urban minor conurbation",15231,10778,5025,5753,60,2328,1806,522,1859,1684,175,206
"2011","Ashfield","E07000170","Urban city and town",35398,24216,11808,12408,175,5919,4649,1270,4621,4207,414,467
"2011","Ashfield","E07000170","Urban city and town in a sparse setting",0,0,0,0,0,0,0,0,0,0,0,0
"2011","Ashfield","E07000170","Rural (total)",302,267,119,148,0,11,5,6,24,17,7,0
"2011","Ashfield","E07000170","Rural town and fringe",0,0,0,0,0,0,0,0,0,0,0,0
"2011","Ashfield","E07000170","Rural town and fringe in a sparse setting",0,0,0,0,0,0,0,0,0,0,0,0
"2011","Ashfield","E07000170","Rural village",169,151,51,100,0,4,1,3,14,11,3,0
"2011","Ashfield","E07000170","Rural village in a sparse setting",0,0,0,0,0,0,0,0,0,0,0,0
"2011","Ashfield","E07000170","Rural hamlet and isolated dwellings",133,116,68,48,0,7,4,3,10,6,4,0
"2011","Ashfield","E07000170","Rural hamlet and isolated dwellings in a sparse setting",0,0,0,0,0,0,0,0,0,0,0,0
"2011","Bassetlaw","E07000171","Total",47667,33115,16295,16820,172,7579,6152,1427,5975,5362,613,826
"2011","Bassetlaw","E07000171","Urban (total)",28144,18735,8727,10008,106,4987,4044,943,3878,3542,336,438
"2011","Bassetlaw","E07000171","Urban major conurbation",0,0,0,0,0,0,0,0,0,0,0,0
"2011","Bassetlaw","E07000171","Urban minor conurbation",0,0,0,0,0,0,0,0,0,0,0,0
"2011","Bassetlaw","E07000171","Urban city and town",28144,18735,8727,10008,106,4987,4044,943,3878,3542,336,438
"2011","Bassetlaw","E07000171","Urban city and town in a sparse setting",0,0,0,0,0,0,0,0,0,0,0,0
"2011","Bassetlaw","E07000171","Rural (total)",19523,14380,7568,6812,66,2592,2108,484,2097,1820,277,388
"2011","Bassetlaw","E07000171","Rural town and fringe",8842,6215,3065,3150,29,1571,1356,215,910,802,108,117
"2011","Bassetlaw","E07000171","Rural town and fringe in a sparse setting",0,0,0,0,0,0,0,0,0,0,0,0
"2011","Bassetlaw","E07000171","Rural village",8654,6703,3678,3025,29,918,692,226,839,721,118,165
"2011","Bassetlaw","E07000171","Rural village in a sparse setting",0,0,0,0,0,0,0,0,0,0,0,0
"2011","Bassetlaw","E07000171","Rural hamlet and isolated dwellings",2027,1462,825,637,8,103,60,43,348,297,51,106
"2011","Bassetlaw","E07000171","Rural hamlet and isolated dwellings in a sparse setting",0,0,0,0,0,0,0,0,0,0,0,0
"2011","Broxtowe","E07000172","Total",46820,34270,17351,16919,168,5218,4192,1026,6594,5902,692,570
"2011","Broxtowe","E07000172","Urban (total)",46639,34110,17256,16854,167,5211,4191,1020,6581,5892,689,570
"2011","Broxtowe","E07000172","Urban major conurbation",0,0,0,0,0,0,0,0,0,0,0,0
"2011","Broxtowe","E07000172","Urban minor conurbation",45530,33207,16764,16443,159,5121,4118,1003,6492,5816,676,551
"2011","Broxtowe","E07000172","Urban city and town",1109,903,492,411,8,90,73,17,89,76,13,19
"2011","Broxtowe","E07000172","Urban city and town in a sparse setting",0,0,0,0,0,0,0,0,0,0,0,0
"2011","Broxtowe","E07000172","Rural (total)",181,160,95,65,1,7,1,6,13,10,3,0
"2011","Broxtowe","E07000172","Rural town and fringe",0,0,0,0,0,0,0,0,0,0,0,0
"2011","Broxtowe","E07000172","Rural town and fringe in a sparse setting",0,0,0,0,0,0,0,0,0,0,0,0
"2011","Broxtowe","E07000172","Rural village",0,0,0,0,0,0,0,0,0,0,0,0
"2011","Broxtowe","E07000172","Rural village in a sparse setting",0,0,0,0,0,0,0,0,0,0,0,0
"2011","Broxtowe","E07000172","Rural hamlet and isolated dwellings",181,160,95,65,1,7,1,6,13,10,3,0
"2011","Broxtowe","E07000172","Rural hamlet and isolated dwellings in a sparse setting",0,0,0,0,0,0,0,0,0,0,0,0
"2011","Gedling","E07000173","Total",49349,37138,18603,18535,271,4926,1961,2965,6488,5850,638,526
"2011","Gedling","E07000173","Urban (total)",40373,29703,14271,15432,249,4423,1806,2617,5605,5088,517,393
"2011","Gedling","E07000173","Urban major conurbation",0,0,0,0,0,0,0,0,0,0,0,0
"2011","Gedling","E07000173","Urban minor conurbation",39748,29292,14108,15184,239,4307,1762,2545,5523,5009,514,387
"2011","Gedling","E07000173","Urban city and town",625,411,163,248,10,116,44,72,82,79,3,6
"2011","Gedling","E07000173","Urban city and town in a sparse setting",0,0,0,0,0,0,0,0,0,0,0,0
"2011","Gedling","E07000173","Rural (total)",8976,7435,4332,3103,22,503,155,348,883,762,121,133
"2011","Gedling","E07000173","Rural town and fringe",7005,5872,3352,2520,20,439,135,304,574,495,79,100
"2011","Gedling","E07000173","Rural town and fringe in a sparse setting",0,0,0,0,0,0,0,0,0,0,0,0
"2011","Gedling","E07000173","Rural village",1218,924,601,323,1,54,18,36,227,206,21,12
"2011","Gedling","E07000173","Rural village in a sparse setting",0,0,0,0,0,0,0,0,0,0,0,0
"2011","Gedling","E07000173","Rural hamlet and isolated dwellings",753,639,379,260,1,10,2,8,82,61,21,21
"2011","Gedling","E07000173","Rural hamlet and isolated dwellings in a sparse setting",0,0,0,0,0,0,0,0,0,0,0,0
"2011","Mansfield","E07000174","Total",44928,29908,14658,15250,169,8199,6208,1991,6115,5616,499,537
"2011","Mansfield","E07000174","Urban (total)",39283,26247,12655,13592,140,7008,5438,1570,5436,5001,435,452
"2011","Mansfield","E07000174","Urban major conurbation",0,0,0,0,0,0,0,0,0,0,0,0
"2011","Mansfield","E07000174","Urban minor conurbation",0,0,0,0,0,0,0,0,0,0,0,0
"2011","Mansfield","E07000174","Urban city and town",39283,26247,12655,13592,140,7008,5438,1570,5436,5001,435,452
"2011","Mansfield","E07000174","Urban city and town in a sparse setting",0,0,0,0,0,0,0,0,0,0,0,0
"2011","Mansfield","E07000174","Rural (total)",5645,3661,2003,1658,29,1191,770,421,679,615,64,85
"2011","Mansfield","E07000174","Rural town and fringe",5343,3470,1922,1548,15,1145,764,381,635,577,58,78
"2011","Mansfield","E07000174","Rural town and fringe in a sparse setting",0,0,0,0,0,0,0,0,0,0,0,0
"2011","Mansfield","E07000174","Rural village",302,191,81,110,14,46,6,40,44,38,6,7
"2011","Mansfield","E07000174","Rural village in a sparse setting",0,0,0,0,0,0,0,0,0,0,0,0
"2011","Mansfield","E07000174","Rural hamlet and isolated dwellings",0,0,0,0,0,0,0,0,0,0,0,0
"2011","Mansfield","E07000174","Rural hamlet and isolated dwellings in a sparse setting",0,0,0,0,0,0,0,0,0,0,0,0
"2011","Newark and Sherwood","E07000175","Total",48773,34455,17399,17056,253,7050,5087,1963,6278,5648,630,737
"2011","Newark and Sherwood","E07000175","Urban (total)",20834,13568,6108,7460,157,3620,2709,911,3198,2964,234,291
"2011","Newark and Sherwood","E07000175","Urban major conurbation",0,0,0,0,0,0,0,0,0,0,0,0
"2011","Newark and Sherwood","E07000175","Urban minor conurbation",0,0,0,0,0,0,0,0,0,0,0,0
"2011","Newark and Sherwood","E07000175","Urban city and town",20834,13568,6108,7460,157,3620,2709,911,3198,2964,234,291
"2011","Newark and Sherwood","E07000175","Urban city and town in a sparse setting",0,0,0,0,0,0,0,0,0,0,0,0
"2011","Newark and Sherwood","E07000175","Rural (total)",27939,20887,11291,9596,96,3430,2378,1052,3080,2684,396,446
"2011","Newark and Sherwood","E07000175","Rural town and fringe",19066,13666,7183,6483,60,2920,1990,930,2142,1891,251,278
"2011","Newark and Sherwood","E07000175","Rural town and fringe in a sparse setting",0,0,0,0,0,0,0,0,0,0,0,0
"2011","Newark and Sherwood","E07000175","Rural village",6271,5152,2933,2219,26,372,298,74,598,521,77,123
"2011","Newark and Sherwood","E07000175","Rural village in a sparse setting",0,0,0,0,0,0,0,0,0,0,0,0
"2011","Newark and Sherwood","E07000175","Rural hamlet and isolated dwellings",2602,2069,1175,894,10,138,90,48,340,272,68,45
"2011","Newark and Sherwood","E07000175","Rural hamlet and isolated dwellings in a sparse setting",0,0,0,0,0,0,0,0,0,0,0,0
"2011","Rushcliffe","E07000176","Total",45835,35142,17973,17169,333,3854,1056,2798,6082,5595,487,424
"2011","Rushcliffe","E07000176","Urban (total)",19923,14360,6712,7648,166,1631,382,1249,3617,3400,217,149
"2011","Rushcliffe","E07000176","Urban major conurbation",0,0,0,0,0,0,0,0,0,0,0,0
"2011","Rushcliffe","E07000176","Urban minor conurbation",19796,14281,6658,7623,165,1595,372,1223,3607,3391,216,148
"2011","Rushcliffe","E07000176","Urban city and town",127,79,54,25,1,36,10,26,10,9,1,1
"2011","Rushcliffe","E07000176","Urban city and town in a sparse setting",0,0,0,0,0,0,0,0,0,0,0,0
"2011","Rushcliffe","E07000176","Rural (total)",25912,20782,11261,9521,167,2223,674,1549,2465,2195,270,275
"2011","Rushcliffe","E07000176","Rural town and fringe",18828,14961,8112,6849,138,1936,606,1330,1623,1446,177,170
"2011","Rushcliffe","E07000176","Rural town and fringe in a sparse setting",0,0,0,0,0,0,0,0,0,0,0,0
"2011","Rushcliffe","E07000176","Rural village",6207,5117,2764,2353,17,256,61,195,723,643,80,94
"2011","Rushcliffe","E07000176","Rural village in a sparse setting",0,0,0,0,0,0,0,0,0,0,0,0
"2011","Rushcliffe","E07000176","Rural hamlet and isolated dwellings",877,704,385,319,12,31,7,24,119,106,13,11
"2011","Rushcliffe","E07000176","Rural hamlet and isolated dwellings in a sparse setting",0,0,0,0,0,0,0,0,0,0,0,0
"2011","Herefordshire, County of","E06000019","Total",78319,53014,30867,22147,770,10903,2692,8211,12147,10680,1467,1485
"2011","Herefordshire, County of","E06000019","Urban (total)",36652,22955,12125,10830,413,6810,2014,4796,5980,5309,671,494
"2011","Herefordshire, County of","E06000019","Urban major conurbation",0,0,0,0,0,0,0,0,0,0,0,0
"2011","Herefordshire, County of","E06000019","Urban minor conurbation",0,0,0,0,0,0,0,0,0,0,0,0
"2011","Herefordshire, County of","E06000019","Urban city and town",35851,22615,11972,10643,400,6511,1991,4520,5840,5180,660,485
"2011","Herefordshire, County of","E06000019","Urban city and town in a sparse setting",801,340,153,187,13,299,23,276,140,129,11,9
"2011","Herefordshire, County of","E06000019","Rural (total)",41667,30059,18742,11317,357,4093,678,3415,6167,5371,796,991
"2011","Herefordshire, County of","E06000019","Rural town and fringe",6809,4418,2612,1806,123,1167,138,1029,997,893,104,104
"2011","Herefordshire, County of","E06000019","Rural town and fringe in a sparse setting",1121,612,389,223,18,226,16,210,242,226,16,23
"2011","Herefordshire, County of","E06000019","Rural village",13618,10120,6076,4044,111,1531,312,1219,1606,1413,193,250
"2011","Herefordshire, County of","E06000019","Rural village in a sparse setting",2889,2111,1345,766,22,322,25,297,361,313,48,73
"2011","Herefordshire, County of","E06000019","Rural hamlet and isolated dwellings",12619,9460,5967,3493,53,602,136,466,2152,1812,340,352
"2011","Herefordshire, County of","E06000019","Rural hamlet and isolated dwellings in a sparse setting",4611,3338,2353,985,30,245,51,194,809,714,95,189
"2011","Shropshire","E06000051","Total",129674,89688,49998,39690,830,17448,6458,10990,19421,17013,2408,2287
"2011","Shropshire","E06000051","Urban (total)",57625,38401,20020,18381,402,9338,3421,5917,8733,7940,793,751
"2011","Shropshire","E06000051","Urban major conurbation",0,0,0,0,0,0,0,0,0,0,0,0
"2011","Shropshire","E06000051","Urban minor conurbation",0,0,0,0,0,0,0,0,0,0,0,0
"2011","Shropshire","E06000051","Urban city and town",52639,35196,17924,17272,315,8434,3338,5096,8005,7283,722,689
"2011","Shropshire","E06000051","Urban city and town in a sparse setting",4986,3205,2096,1109,87,904,83,821,728,657,71,62
"2011","Shropshire","E06000051","Rural (total)",72049,51287,29978,21309,428,8110,3037,5073,10688,9073,1615,1536
"2011","Shropshire","E06000051","Rural town and fringe",28321,19741,11137,8604,174,4347,1925,2422,3647,3155,492,412
"2011","Shropshire","E06000051","Rural town and fringe in a sparse setting",1935,1149,732,417,31,409,36,373,312,262,50,34
"2011","Shropshire","E06000051","Rural village",17112,12416,7148,5268,106,1867,646,1221,2360,1800,560,363
"2011","Shropshire","E06000051","Rural village in a sparse setting",2089,1491,1028,463,17,230,23,207,286,258,28,65
"2011","Shropshire","E06000051","Rural hamlet and isolated dwellings",18911,13913,8131,5782,84,1079,389,690,3332,2921,411,503
"2011","Shropshire","E06000051","Rural hamlet and isolated dwellings in a sparse setting",3681,2577,1802,775,16,178,18,160,751,677,74,159
"2011","Stoke-on-Trent","E06000021","Total",107575,63928,30628,33300,419,25999,19712,6287,15440,14176,1264,1789
"2011","Stoke-on-Trent","E06000021","Urban (total)",107272,63748,30532,33216,419,25918,19640,6278,15408,14146,1262,1779
"2011","Stoke-on-Trent","E06000021","Urban major conurbation",0,0,0,0,0,0,0,0,0,0,0,0
"2011","Stoke-on-Trent","E06000021","Urban minor conurbation",0,0,0,0,0,0,0,0,0,0,0,0
"2011","Stoke-on-Trent","E06000021","Urban city and town",107272,63748,30532,33216,419,25918,19640,6278,15408,14146,1262,1779
"2011","Stoke-on-Trent","E06000021","Urban city and town in a sparse setting",0,0,0,0,0,0,0,0,0,0,0,0
"2011","Stoke-on-Trent","E06000021","Rural (total)",303,180,96,84,0,81,72,9,32,30,2,10
"2011","Stoke-on-Trent","E06000021","Rural town and fringe",0,0,0,0,0,0,0,0,0,0,0,0
"2011","Stoke-on-Trent","E06000021","Rural town and fringe in a sparse setting",0,0,0,0,0,0,0,0,0,0,0,0
"2011","Stoke-on-Trent","E06000021","Rural village",225,142,78,64,0,59,52,7,16,15,1,8
"2011","Stoke-on-Trent","E06000021","Rural village in a sparse setting",0,0,0,0,0,0,0,0,0,0,0,0
"2011","Stoke-on-Trent","E06000021","Rural hamlet and isolated dwellings",78,38,18,20,0,22,20,2,16,15,1,2
"2011","Stoke-on-Trent","E06000021","Rural hamlet and isolated dwellings in a sparse setting",0,0,0,0,0,0,0,0,0,0,0,0
"2011","Telford and Wrekin","E06000020","Total",66608,42417,18106,24311,292,13106,5409,7697,9979,9055,924,814
"2011","Telford and Wrekin","E06000020","Urban (total)",62445,39271,16419,22852,276,12703,5290,7413,9470,8611,859,725
"2011","Telford and Wrekin","E06000020","Urban major conurbation",0,0,0,0,0,0,0,0,0,0,0,0
"2011","Telford and Wrekin","E06000020","Urban minor conurbation",0,0,0,0,0,0,0,0,0,0,0,0
"2011","Telford and Wrekin","E06000020","Urban city and town",62445,39271,16419,22852,276,12703,5290,7413,9470,8611,859,725
"2011","Telford and Wrekin","E06000020","Urban city and town in a sparse setting",0,0,0,0,0,0,0,0,0,0,0,0
"2011","Telford and Wrekin","E06000020","Rural (total)",4163,3146,1687,1459,16,403,119,284,509,444,65,89
"2011","Telford and Wrekin","E06000020","Rural town and fringe",208,116,26,90,1,67,6,61,22,17,5,2
"2011","Telford and Wrekin","E06000020","Rural town and fringe in a sparse setting",0,0,0,0,0,0,0,0,0,0,0,0
"2011","Telford and Wrekin","E06000020","Rural village",2405,1901,1076,825,10,251,80,171,203,178,25,40
"2011","Telford and Wrekin","E06000020","Rural village in a sparse setting",0,0,0,0,0,0,0,0,0,0,0,0
"2011","Telford and Wrekin","E06000020","Rural hamlet and isolated dwellings",1550,1129,585,544,5,85,33,52,284,249,35,47
"2011","Telford and Wrekin","E06000020","Rural hamlet and isolated dwellings in a sparse setting",0,0,0,0,0,0,0,0,0,0,0,0
"2011","Cannock Chase","E07000192","Total",40664,28106,12388,15718,248,6880,5291,1589,4938,4509,429,492
"2011","Cannock Chase","E07000192","Urban (total)",36262,24818,10890,13928,235,6248,4810,1438,4522,4131,391,439
"2011","Cannock Chase","E07000192","Urban major conurbation",25762,17201,7367,9834,188,4860,3817,1043,3173,2891,282,340
"2011","Cannock Chase","E07000192","Urban minor conurbation",0,0,0,0,0,0,0,0,0,0,0,0
"2011","Cannock Chase","E07000192","Urban city and town",10500,7617,3523,4094,47,1388,993,395,1349,1240,109,99
"2011","Cannock Chase","E07000192","Urban city and town in a sparse setting",0,0,0,0,0,0,0,0,0,0,0,0
"2011","Cannock Chase","E07000192","Rural (total)",4402,3288,1498,1790,13,632,481,151,416,378,38,53
"2011","Cannock Chase","E07000192","Rural town and fringe",3205,2324,986,1338,12,520,415,105,313,291,22,36
"2011","Cannock Chase","E07000192","Rural town and fringe in a sparse setting",0,0,0,0,0,0,0,0,0,0,0,0
"2011","Cannock Chase","E07000192","Rural village",819,650,352,298,1,106,61,45,49,38,11,13
"2011","Cannock Chase","E07000192","Rural village in a sparse setting",0,0,0,0,0,0,0,0,0,0,0,0
"2011","Cannock Chase","E07000192","Rural hamlet and isolated dwellings",378,314,160,154,0,6,5,1,54,49,5,4
"2011","Cannock Chase","E07000192","Rural hamlet and isolated dwellings in a sparse setting",0,0,0,0,0,0,0,0,0,0,0,0
"2011","East Staffordshire","E07000193","Total",47251,32879,16574,16305,260,6367,1984,4383,7152,6519,633,593
"2011","East Staffordshire","E07000193","Urban (total)",36702,24518,11865,12653,211,5515,1757,3758,6063,5581,482,395
"2011","East Staffordshire","E07000193","Urban major conurbation",0,0,0,0,0,0,0,0,0,0,0,0
"2011","East Staffordshire","E07000193","Urban minor conurbation",0,0,0,0,0,0,0,0,0,0,0,0
"2011","East Staffordshire","E07000193","Urban city and town",36702,24518,11865,12653,211,5515,1757,3758,6063,5581,482,395
"2011","East Staffordshire","E07000193","Urban city and town in a sparse setting",0,0,0,0,0,0,0,0,0,0,0,0
"2011","East Staffordshire","E07000193","Rural (total)",10549,8361,4709,3652,49,852,227,625,1089,938,151,198
"2011","East Staffordshire","E07000193","Rural town and fringe",4914,3771,2094,1677,31,564,151,413,481,416,65,67
"2011","East Staffordshire","E07000193","Rural town and fringe in a sparse setting",0,0,0,0,0,0,0,0,0,0,0,0
"2011","East Staffordshire","E07000193","Rural village",2784,2308,1281,1027,7,170,41,129,254,221,33,45
"2011","East Staffordshire","E07000193","Rural village in a sparse setting",0,0,0,0,0,0,0,0,0,0,0,0
"2011","East Staffordshire","E07000193","Rural hamlet and isolated dwellings",2851,2282,1334,948,11,118,35,83,354,301,53,86
"2011","East Staffordshire","E07000193","Rural hamlet and isolated dwellings in a sparse setting",0,0,0,0,0,0,0,0,0,0,0,0
"2011","Lichfield","E07000194","Total",41224,31155,15948,15207,242,5446,648,4798,3932,3475,457,449
"2011","Lichfield","E07000194","Urban (total)",29594,21838,11168,10670,192,4447,532,3915,2810,2542,268,307
"2011","Lichfield","E07000194","Urban major conurbation",12346,9872,5140,4732,64,1402,181,1221,909,805,104,99
"2011","Lichfield","E07000194","Urban minor conurbation",0,0,0,0,0,0,0,0,0,0,0,0
"2011","Lichfield","E07000194","Urban city and town",17248,11966,6028,5938,128,3045,351,2694,1901,1737,164,208
"2011","Lichfield","E07000194","Urban city and town in a sparse setting",0,0,0,0,0,0,0,0,0,0,0,0
"2011","Lichfield","E07000194","Rural (total)",11630,9317,4780,4537,50,999,116,883,1122,933,189,142
"2011","Lichfield","E07000194","Rural town and fringe",5753,4633,2230,2403,30,537,53,484,508,455,53,45
"2011","Lichfield","E07000194","Rural town and fringe in a sparse setting",0,0,0,0,0,0,0,0,0,0,0,0
"2011","Lichfield","E07000194","Rural village",3084,2443,1352,1091,7,298,39,259,302,214,88,34
"2011","Lichfield","E07000194","Rural village in a sparse setting",0,0,0,0,0,0,0,0,0,0,0,0
"2011","Lichfield","E07000194","Rural hamlet and isolated dwellings",2793,2241,1198,1043,13,164,24,140,312,264,48,63
"2011","Lichfield","E07000194","Rural hamlet and isolated dwellings in a sparse setting",0,0,0,0,0,0,0,0,0,0,0,0
"2011","Newcastle-under-Lyme","E07000195","Total",52574,36332,18495,17837,226,9840,3399,6441,5511,4932,579,665
"2011","Newcastle-under-Lyme","E07000195","Urban (total)",43073,28920,14472,14448,195,8785,3079,5706,4635,4184,451,538
"2011","Newcastle-under-Lyme","E07000195","Urban major conurbation",0,0,0,0,0,0,0,0,0,0,0,0
"2011","Newcastle-under-Lyme","E07000195","Urban minor conurbation",0,0,0,0,0,0,0,0,0,0,0,0
"2011","Newcastle-under-Lyme","E07000195","Urban city and town",43073,28920,14472,14448,195,8785,3079,5706,4635,4184,451,538
"2011","Newcastle-under-Lyme","E07000195","Urban city and town in a sparse setting",0,0,0,0,0,0,0,0,0,0,0,0
"2011","Newcastle-under-Lyme","E07000195","Rural (total)",9501,7412,4023,3389,31,1055,320,735,876,748,128,127
"2011","Newcastle-under-Lyme","E07000195","Rural town and fringe",5501,4244,2166,2078,15,717,242,475,468,424,44,57
"2011","Newcastle-under-Lyme","E07000195","Rural town and fringe in a sparse setting",0,0,0,0,0,0,0,0,0,0,0,0
"2011","Newcastle-under-Lyme","E07000195","Rural village",2786,2180,1265,915,13,271,60,211,272,211,61,50
"2011","Newcastle-under-Lyme","E07000195","Rural village in a sparse setting",0,0,0,0,0,0,0,0,0,0,0,0
"2011","Newcastle-under-Lyme","E07000195","Rural hamlet and isolated dwellings",1214,988,592,396,3,67,18,49,136,113,23,20
"2011","Newcastle-under-Lyme","E07000195","Rural hamlet and isolated dwellings in a sparse setting",0,0,0,0,0,0,0,0,0,0,0,0
"2011","South Staffordshire","E07000196","Total",44458,33669,17809,15860,249,6193,646,5547,3772,3371,401,575
"2011","South Staffordshire","E07000196","Urban (total)",27047,20406,10271,10135,185,4232,451,3781,1956,1748,208,268
"2011","South Staffordshire","E07000196","Urban major conurbation",26172,19676,9838,9838,185,4175,444,3731,1882,1683,199,254
"2011","South Staffordshire","E07000196","Urban minor conurbation",0,0,0,0,0,0,0,0,0,0,0,0
"2011","South Staffordshire","E07000196","Urban city and town",875,730,433,297,0,57,7,50,74,65,9,14
"2011","South Staffordshire","E07000196","Urban city and town in a sparse setting",0,0,0,0,0,0,0,0,0,0,0,0
"2011","South Staffordshire","E07000196","Rural (total)",17411,13263,7538,5725,64,1961,195,1766,1816,1623,193,307
"2011","South Staffordshire","E07000196","Rural town and fringe",10891,8313,4554,3759,35,1568,142,1426,841,756,85,134
"2011","South Staffordshire","E07000196","Rural town and fringe in a sparse setting",0,0,0,0,0,0,0,0,0,0,0,0
"2011","South Staffordshire","E07000196","Rural village",3853,3011,1818,1193,16,284,36,248,472,423,49,70
"2011","South Staffordshire","E07000196","Rural village in a sparse setting",0,0,0,0,0,0,0,0,0,0,0,0
"2011","South Staffordshire","E07000196","Rural hamlet and isolated dwellings",2667,1939,1166,773,13,109,17,92,503,444,59,103
"2011","South Staffordshire","E07000196","Rural hamlet and isolated dwellings in a sparse setting",0,0,0,0,0,0,0,0,0,0,0,0
"2011","Stafford","E07000197","Total",55703,39880,20259,19621,279,7618,2420,5198,7206,6239,967,720
"2011","Stafford","E07000197","Urban (total)",38829,26435,12839,13596,224,6234,1866,4368,5507,4756,751,429
"2011","Stafford","E07000197","Urban major conurbation",0,0,0,0,0,0,0,0,0,0,0,0
"2011","Stafford","E07000197","Urban minor conurbation",0,0,0,0,0,0,0,0,0,0,0,0
"2011","Stafford","E07000197","Urban city and town",38829,26435,12839,13596,224,6234,1866,4368,5507,4756,751,429
"2011","Stafford","E07000197","Urban city and town in a sparse setting",0,0,0,0,0,0,0,0,0,0,0,0
"2011","Stafford","E07000197","Rural (total)",16874,13445,7420,6025,55,1384,554,830,1699,1483,216,291
"2011","Stafford","E07000197","Rural town and fringe",6493,5289,2822,2467,25,581,201,380,517,455,62,81
"2011","Stafford","E07000197","Rural town and fringe in a sparse setting",0,0,0,0,0,0,0,0,0,0,0,0
"2011","Stafford","E07000197","Rural village",6698,5426,3124,2302,19,564,244,320,576,509,67,113
"2011","Stafford","E07000197","Rural village in a sparse setting",0,0,0,0,0,0,0,0,0,0,0,0
"2011","Stafford","E07000197","Rural hamlet and isolated dwellings",3683,2730,1474,1256,11,239,109,130,606,519,87,97
"2011","Stafford","E07000197","Rural hamlet and isolated dwellings in a sparse setting",0,0,0,0,0,0,0,0,0,0,0,0
"2011","Staffordshire Moorlands","E07000198","Total",41772,33288,18413,14875,127,3699,1343,2356,4103,3595,508,555
"2011","Staffordshire Moorlands","E07000198","Urban (total)",28578,22296,12134,10162,80,3028,1103,1925,2848,2533,315,326
"2011","Staffordshire Moorlands","E07000198","Urban major conurbation",0,0,0,0,0,0,0,0,0,0,0,0
"2011","Staffordshire Moorlands","E07000198","Urban minor conurbation",0,0,0,0,0,0,0,0,0,0,0,0
"2011","Staffordshire Moorlands","E07000198","Urban city and town",28578,22296,12134,10162,80,3028,1103,1925,2848,2533,315,326
"2011","Staffordshire Moorlands","E07000198","Urban city and town in a sparse setting",0,0,0,0,0,0,0,0,0,0,0,0
"2011","Staffordshire Moorlands","E07000198","Rural (total)",13194,10992,6279,4713,47,671,240,431,1255,1062,193,229
"2011","Staffordshire Moorlands","E07000198","Rural town and fringe",3477,2978,1558,1420,6,188,75,113,264,222,42,41
"2011","Staffordshire Moorlands","E07000198","Rural town and fringe in a sparse setting",0,0,0,0,0,0,0,0,0,0,0,0
"2011","Staffordshire Moorlands","E07000198","Rural village",4855,4002,2228,1774,14,308,121,187,448,392,56,83
"2011","Staffordshire Moorlands","E07000198","Rural village in a sparse setting",0,0,0,0,0,0,0,0,0,0,0,0
"2011","Staffordshire Moorlands","E07000198","Rural hamlet and isolated dwellings",4862,4012,2493,1519,27,175,44,131,543,448,95,105
"2011","Staffordshire Moorlands","E07000198","Rural hamlet and isolated dwellings in a sparse setting",0,0,0,0,0,0,0,0,0,0,0,0
"2011","Tamworth","E07000199","Total",31617,21575,8790,12785,158,6108,4482,1626,3476,3157,319,300
"2011","Tamworth","E07000199","Urban (total)",31617,21575,8790,12785,158,6108,4482,1626,3476,3157,319,300
"2011","Tamworth","E07000199","Urban major conurbation",0,0,0,0,0,0,0,0,0,0,0,0
"2011","Tamworth","E07000199","Urban minor conurbation",0,0,0,0,0,0,0,0,0,0,0,0
"2011","Tamworth","E07000199","Urban city and town",31617,21575,8790,12785,158,6108,4482,1626,3476,3157,319,300
"2011","Tamworth","E07000199","Urban city and town in a sparse setting",0,0,0,0,0,0,0,0,0,0,0,0
"2011","Tamworth","E07000199","Rural (total)",0,0,0,0,0,0,0,0,0,0,0,0
"2011","Tamworth","E07000199","Rural town and fringe",0,0,0,0,0,0,0,0,0,0,0,0
"2011","Tamworth","E07000199","Rural town and fringe in a sparse setting",0,0,0,0,0,0,0,0,0,0,0,0
"2011","Tamworth","E07000199","Rural village",0,0,0,0,0,0,0,0,0,0,0,0
"2011","Tamworth","E07000199","Rural village in a sparse setting",0,0,0,0,0,0,0,0,0,0,0,0
"2011","Tamworth","E07000199","Rural hamlet and isolated dwellings",0,0,0,0,0,0,0,0,0,0,0,0
"2011","Tamworth","E07000199","Rural hamlet and isolated dwellings in a sparse setting",0,0,0,0,0,0,0,0,0,0,0,0
"2011","North Warwickshire","E07000218","Total",25812,18686,9007,9679,176,3719,2687,1032,2913,2635,278,318
"2011","North Warwickshire","E07000218","Urban (total)",6681,4312,2077,2235,55,1429,1004,425,798,738,60,87
"2011","North Warwickshire","E07000218","Urban major conurbation",0,0,0,0,0,0,0,0,0,0,0,0
"2011","North Warwickshire","E07000218","Urban minor conurbation",0,0,0,0,0,0,0,0,0,0,0,0
"2011","North Warwickshire","E07000218","Urban city and town",6681,4312,2077,2235,55,1429,1004,425,798,738,60,87
"2011","North Warwickshire","E07000218","Urban city and town in a sparse setting",0,0,0,0,0,0,0,0,0,0,0,0
"2011","North Warwickshire","E07000218","Rural (total)",19131,14374,6930,7444,121,2290,1683,607,2115,1897,218,231
"2011","North Warwickshire","E07000218","Rural town and fringe",12834,9557,4463,5094,111,1705,1188,517,1328,1200,128,133
"2011","North Warwickshire","E07000218","Rural town and fringe in a sparse setting",0,0,0,0,0,0,0,0,0,0,0,0
"2011","North Warwickshire","E07000218","Rural village",3629,2763,1409,1354,8,453,390,63,357,306,51,48
"2011","North Warwickshire","E07000218","Rural village in a sparse setting",0,0,0,0,0,0,0,0,0,0,0,0
"2011","North Warwickshire","E07000218","Rural hamlet and isolated dwellings",2668,2054,1058,996,2,132,105,27,430,391,39,50
"2011","North Warwickshire","E07000218","Rural hamlet and isolated dwellings in a sparse setting",0,0,0,0,0,0,0,0,0,0,0,0
"2011","Nuneaton and Bedworth","E07000219","Total",52711,37617,17545,20072,270,7633,5785,1848,6683,6041,642,508
"2011","Nuneaton and Bedworth","E07000219","Urban (total)",52711,37617,17545,20072,270,7633,5785,1848,6683,6041,642,508
"2011","Nuneaton and Bedworth","E07000219","Urban major conurbation",0,0,0,0,0,0,0,0,0,0,0,0
"2011","Nuneaton and Bedworth","E07000219","Urban minor conurbation",0,0,0,0,0,0,0,0,0,0,0,0
"2011","Nuneaton and Bedworth","E07000219","Urban city and town",52711,37617,17545,20072,270,7633,5785,1848,6683,6041,642,508
"2011","Nuneaton and Bedworth","E07000219","Urban city and town in a sparse setting",0,0,0,0,0,0,0,0,0,0,0,0
"2011","Nuneaton and Bedworth","E07000219","Rural (total)",0,0,0,0,0,0,0,0,0,0,0,0
"2011","Nuneaton and Bedworth","E07000219","Rural town and fringe",0,0,0,0,0,0,0,0,0,0,0,0
"2011","Nuneaton and Bedworth","E07000219","Rural town and fringe in a sparse setting",0,0,0,0,0,0,0,0,0,0,0,0
"2011","Nuneaton and Bedworth","E07000219","Rural village",0,0,0,0,0,0,0,0,0,0,0,0
"2011","Nuneaton and Bedworth","E07000219","Rural village in a sparse setting",0,0,0,0,0,0,0,0,0,0,0,0
"2011","Nuneaton and Bedworth","E07000219","Rural hamlet and isolated dwellings",0,0,0,0,0,0,0,0,0,0,0,0
"2011","Nuneaton and Bedworth","E07000219","Rural hamlet and isolated dwellings in a sparse setting",0,0,0,0,0,0,0,0,0,0,0,0
"2011","Rugby","E07000220","Total",41875,29086,13772,15314,403,5993,3860,2133,5903,5281,622,490
"2011","Rugby","E07000220","Urban (total)",31909,21431,9702,11729,340,4901,2979,1922,4887,4505,382,350
"2011","Rugby","E07000220","Urban major conurbation",0,0,0,0,0,0,0,0,0,0,0,0
"2011","Rugby","E07000220","Urban minor conurbation",0,0,0,0,0,0,0,0,0,0,0,0
"2011","Rugby","E07000220","Urban city and town",31909,21431,9702,11729,340,4901,2979,1922,4887,4505,382,350
"2011","Rugby","E07000220","Urban city and town in a sparse setting",0,0,0,0,0,0,0,0,0,0,0,0
"2011","Rugby","E07000220","Rural (total)",9966,7655,4070,3585,63,1092,881,211,1016,776,240,140
"2011","Rugby","E07000220","Rural town and fringe",3929,2879,1384,1495,44,592,480,112,361,317,44,53
"2011","Rugby","E07000220","Rural town and fringe in a sparse setting",0,0,0,0,0,0,0,0,0,0,0,0
"2011","Rugby","E07000220","Rural village",4662,3645,2002,1643,15,424,340,84,511,332,179,67
"2011","Rugby","E07000220","Rural village in a sparse setting",0,0,0,0,0,0,0,0,0,0,0,0
"2011","Rugby","E07000220","Rural hamlet and isolated dwellings",1375,1131,684,447,4,76,61,15,144,127,17,20
"2011","Rugby","E07000220","Rural hamlet and isolated dwellings in a sparse setting",0,0,0,0,0,0,0,0,0,0,0,0
"2011","Stratford-on-Avon","E07000221","Total",51928,37304,20315,16989,561,6713,594,6119,6596,5885,711,754
"2011","Stratford-on-Avon","E07000221","Urban (total)",12651,8401,4588,3813,195,1616,130,1486,2314,2144,170,125
"2011","Stratford-on-Avon","E07000221","Urban major conurbation",0,0,0,0,0,0,0,0,0,0,0,0
"2011","Stratford-on-Avon","E07000221","Urban minor conurbation",0,0,0,0,0,0,0,0,0,0,0,0
"2011","Stratford-on-Avon","E07000221","Urban city and town",12651,8401,4588,3813,195,1616,130,1486,2314,2144,170,125
"2011","Stratford-on-Avon","E07000221","Urban city and town in a sparse setting",0,0,0,0,0,0,0,0,0,0,0,0
"2011","Stratford-on-Avon","E07000221","Rural (total)",39277,28903,15727,13176,366,5097,464,4633,4282,3741,541,629
"2011","Stratford-on-Avon","E07000221","Rural town and fringe",20261,14523,7447,7076,224,3189,304,2885,2076,1882,194,249
"2011","Stratford-on-Avon","E07000221","Rural town and fringe in a sparse setting",0,0,0,0,0,0,0,0,0,0,0,0
"2011","Stratford-on-Avon","E07000221","Rural village",13828,10519,5987,4532,118,1666,129,1537,1279,1061,218,246
"2011","Stratford-on-Avon","E07000221","Rural village in a sparse setting",0,0,0,0,0,0,0,0,0,0,0,0
"2011","Stratford-on-Avon","E07000221","Rural hamlet and isolated dwellings",5188,3861,2293,1568,24,242,31,211,927,798,129,134
"2011","Stratford-on-Avon","E07000221","Rural hamlet and isolated dwellings in a sparse setting",0,0,0,0,0,0,0,0,0,0,0,0
"2011","Warwick","E07000222","Total",58679,39111,19157,19954,510,7866,5337,2529,10513,9786,727,679
"2011","Warwick","E07000222","Urban (total)",51516,33505,16348,17157,453,7349,5018,2331,9653,9006,647,556
"2011","Warwick","E07000222","Urban major conurbation",0,0,0,0,0,0,0,0,0,0,0,0
"2011","Warwick","E07000222","Urban minor conurbation",0,0,0,0,0,0,0,0,0,0,0,0
"2011","Warwick","E07000222","Urban city and town",51516,33505,16348,17157,453,7349,5018,2331,9653,9006,647,556
"2011","Warwick","E07000222","Urban city and town in a sparse setting",0,0,0,0,0,0,0,0,0,0,0,0
"2011","Warwick","E07000222","Rural (total)",7163,5606,2809,2797,57,517,319,198,860,780,80,123
"2011","Warwick","E07000222","Rural town and fringe",2278,1823,774,1049,33,190,94,96,213,197,16,19
"2011","Warwick","E07000222","Rural town and fringe in a sparse setting",0,0,0,0,0,0,0,0,0,0,0,0
"2011","Warwick","E07000222","Rural village",3061,2427,1309,1118,16,244,164,80,323,293,30,51
"2011","Warwick","E07000222","Rural village in a sparse setting",0,0,0,0,0,0,0,0,0,0,0,0
"2011","Warwick","E07000222","Rural hamlet and isolated dwellings",1824,1356,726,630,8,83,61,22,324,290,34,53
"2011","Warwick","E07000222","Rural hamlet and isolated dwellings in a sparse setting",0,0,0,0,0,0,0,0,0,0,0,0
"2011","Birmingham","E08000025","Total",410736,226616,106416,120200,3940,99592,63458,36134,73405,68647,4758,7183
"2011","Birmingham","E08000025","Urban (total)",410515,226436,106339,120097,3940,99587,63457,36130,73371,68616,4755,7181
"2011","Birmingham","E08000025","Urban major conurbation",410515,226436,106339,120097,3940,99587,63457,36130,73371,68616,4755,7181
"2011","Birmingham","E08000025","Urban minor conurbation",0,0,0,0,0,0,0,0,0,0,0,0
"2011","Birmingham","E08000025","Urban city and town",0,0,0,0,0,0,0,0,0,0,0,0
"2011","Birmingham","E08000025","Urban city and town in a sparse setting",0,0,0,0,0,0,0,0,0,0,0,0
"2011","Birmingham","E08000025","Rural (total)",221,180,77,103,0,5,1,4,34,31,3,2
"2011","Birmingham","E08000025","Rural town and fringe",0,0,0,0,0,0,0,0,0,0,0,0
"2011","Birmingham","E08000025","Rural town and fringe in a sparse setting",0,0,0,0,0,0,0,0,0,0,0,0
"2011","Birmingham","E08000025","Rural village",0,0,0,0,0,0,0,0,0,0,0,0
"2011","Birmingham","E08000025","Rural village in a sparse setting",0,0,0,0,0,0,0,0,0,0,0,0
"2011","Birmingham","E08000025","Rural hamlet and isolated dwellings",221,180,77,103,0,5,1,4,34,31,3,2
"2011","Birmingham","E08000025","Rural hamlet and isolated dwellings in a sparse setting",0,0,0,0,0,0,0,0,0,0,0,0
"2011","Coventry","E08000026","Total",128592,77880,37644,40236,750,21914,6988,14926,26503,24461,2042,1545
"2011","Coventry","E08000026","Urban (total)",128378,77688,37527,40161,749,21910,6986,14924,26486,24446,2040,1545
"2011","Coventry","E08000026","Urban major conurbation",0,0,0,0,0,0,0,0,0,0,0,0
"2011","Coventry","E08000026","Urban minor conurbation",0,0,0,0,0,0,0,0,0,0,0,0
"2011","Coventry","E08000026","Urban city and town",128378,77688,37527,40161,749,21910,6986,14924,26486,24446,2040,1545
"2011","Coventry","E08000026","Urban city and town in a sparse setting",0,0,0,0,0,0,0,0,0,0,0,0
"2011","Coventry","E08000026","Rural (total)",214,192,117,75,1,4,2,2,17,15,2,0
"2011","Coventry","E08000026","Rural town and fringe",0,0,0,0,0,0,0,0,0,0,0,0
"2011","Coventry","E08000026","Rural town and fringe in a sparse setting",0,0,0,0,0,0,0,0,0,0,0,0
"2011","Coventry","E08000026","Rural village",0,0,0,0,0,0,0,0,0,0,0,0
"2011","Coventry","E08000026","Rural village in a sparse setting",0,0,0,0,0,0,0,0,0,0,0,0
"2011","Coventry","E08000026","Rural hamlet and isolated dwellings",214,192,117,75,1,4,2,2,17,15,2,0
"2011","Coventry","E08000026","Rural hamlet and isolated dwellings in a sparse setting",0,0,0,0,0,0,0,0,0,0,0,0
"2011","Dudley","E08000027","Total",129867,89304,45383,43921,707,25719,21874,3845,12004,10938,1066,2133
"2011","Dudley","E08000027","Urban (total)",129757,89203,45335,43868,707,25716,21871,3845,12000,10935,1065,2131
"2011","Dudley","E08000027","Urban major conurbation",129651,89102,45279,43823,707,25716,21871,3845,11995,10930,1065,2131
"2011","Dudley","E08000027","Urban minor conurbation",0,0,0,0,0,0,0,0,0,0,0,0
"2011","Dudley","E08000027","Urban city and town",106,101,56,45,0,0,0,0,5,5,0,0
"2011","Dudley","E08000027","Urban city and town in a sparse setting",0,0,0,0,0,0,0,0,0,0,0,0
"2011","Dudley","E08000027","Rural (total)",110,101,48,53,0,3,3,0,4,3,1,2
"2011","Dudley","E08000027","Rural town and fringe",110,101,48,53,0,3,3,0,4,3,1,2
"2011","Dudley","E08000027","Rural town and fringe in a sparse setting",0,0,0,0,0,0,0,0,0,0,0,0
"2011","Dudley","E08000027","Rural village",0,0,0,0,0,0,0,0,0,0,0,0
"2011","Dudley","E08000027","Rural village in a sparse setting",0,0,0,0,0,0,0,0,0,0,0,0
"2011","Dudley","E08000027","Rural hamlet and isolated dwellings",0,0,0,0,0,0,0,0,0,0,0,0
"2011","Dudley","E08000027","Rural hamlet and isolated dwellings in a sparse setting",0,0,0,0,0,0,0,0,0,0,0,0
"2011","Sandwell","E08000028","Total",121498,69135,32253,36882,701,33439,27587,5852,15674,14583,1091,2549
"2011","Sandwell","E08000028","Urban (total)",121498,69135,32253,36882,701,33439,27587,5852,15674,14583,1091,2549
"2011","Sandwell","E08000028","Urban major conurbation",121498,69135,32253,36882,701,33439,27587,5852,15674,14583,1091,2549
"2011","Sandwell","E08000028","Urban minor conurbation",0,0,0,0,0,0,0,0,0,0,0,0
"2011","Sandwell","E08000028","Urban city and town",0,0,0,0,0,0,0,0,0,0,0,0
"2011","Sandwell","E08000028","Urban city and town in a sparse setting",0,0,0,0,0,0,0,0,0,0,0,0
"2011","Sandwell","E08000028","Rural (total)",0,0,0,0,0,0,0,0,0,0,0,0
"2011","Sandwell","E08000028","Rural town and fringe",0,0,0,0,0,0,0,0,0,0,0,0
"2011","Sandwell","E08000028","Rural town and fringe in a sparse setting",0,0,0,0,0,0,0,0,0,0,0,0
"2011","Sandwell","E08000028","Rural village",0,0,0,0,0,0,0,0,0,0,0,0
"2011","Sandwell","E08000028","Rural village in a sparse setting",0,0,0,0,0,0,0,0,0,0,0,0
"2011","Sandwell","E08000028","Rural hamlet and isolated dwellings",0,0,0,0,0,0,0,0,0,0,0,0
"2011","Sandwell","E08000028","Rural hamlet and isolated dwellings in a sparse setting",0,0,0,0,0,0,0,0,0,0,0,0
"2011","Solihull","E08000029","Total",86056,63559,32227,31332,527,12834,10199,2635,8502,7795,707,634
"2011","Solihull","E08000029","Urban (total)",77586,56989,29108,27881,476,12331,9876,2455,7248,6646,602,542
"2011","Solihull","E08000029","Urban major conurbation",76104,55745,28454,27291,473,12263,9844,2419,7095,6517,578,528
"2011","Solihull","E08000029","Urban minor conurbation",0,0,0,0,0,0,0,0,0,0,0,0
"2011","Solihull","E08000029","Urban city and town",1482,1244,654,590,3,68,32,36,153,129,24,14
"2011","Solihull","E08000029","Urban city and town in a sparse setting",0,0,0,0,0,0,0,0,0,0,0,0
"2011","Solihull","E08000029","Rural (total)",8470,6570,3119,3451,51,503,323,180,1254,1149,105,92
"2011","Solihull","E08000029","Rural town and fringe",6019,4619,2079,2540,35,360,246,114,950,884,66,55
"2011","Solihull","E08000029","Rural town and fringe in a sparse setting",0,0,0,0,0,0,0,0,0,0,0,0
"2011","Solihull","E08000029","Rural village",1038,833,417,416,13,72,55,17,110,90,20,10
"2011","Solihull","E08000029","Rural village in a sparse setting",0,0,0,0,0,0,0,0,0,0,0,0
"2011","Solihull","E08000029","Rural hamlet and isolated dwellings",1413,1118,623,495,3,71,22,49,194,175,19,27
"2011","Solihull","E08000029","Rural hamlet and isolated dwellings in a sparse setting",0,0,0,0,0,0,0,0,0,0,0,0
"2011","Walsall","E08000030","Total",107822,67265,33516,33749,601,25967,10774,15193,12569,11533,1036,1420
"2011","Walsall","E08000030","Urban (total)",106582,66472,33060,33412,578,25675,10633,15042,12454,11433,1021,1403
"2011","Walsall","E08000030","Urban major conurbation",106338,66237,32923,33314,578,25673,10633,15040,12447,11426,1021,1403
"2011","Walsall","E08000030","Urban minor conurbation",0,0,0,0,0,0,0,0,0,0,0,0
"2011","Walsall","E08000030","Urban city and town",244,235,137,98,0,2,0,2,7,7,0,0
"2011","Walsall","E08000030","Urban city and town in a sparse setting",0,0,0,0,0,0,0,0,0,0,0,0
"2011","Walsall","E08000030","Rural (total)",1240,793,456,337,23,292,141,151,115,100,15,17
"2011","Walsall","E08000030","Rural town and fringe",889,488,245,243,20,287,140,147,82,70,12,12
"2011","Walsall","E08000030","Rural town and fringe in a sparse setting",0,0,0,0,0,0,0,0,0,0,0,0
"2011","Walsall","E08000030","Rural village",282,243,155,88,3,4,0,4,27,25,2,5
"2011","Walsall","E08000030","Rural village in a sparse setting",0,0,0,0,0,0,0,0,0,0,0,0
"2011","Walsall","E08000030","Rural hamlet and isolated dwellings",69,62,56,6,0,1,1,0,6,5,1,0
"2011","Walsall","E08000030","Rural hamlet and isolated dwellings in a sparse setting",0,0,0,0,0,0,0,0,0,0,0,0
"2011","Wolverhampton","E08000031","Total",102177,57812,29416,28396,419,28648,22796,5852,13455,12517,938,1843
"2011","Wolverhampton","E08000031","Urban (total)",102177,57812,29416,28396,419,28648,22796,5852,13455,12517,938,1843
"2011","Wolverhampton","E08000031","Urban major conurbation",102177,57812,29416,28396,419,28648,22796,5852,13455,12517,938,1843
"2011","Wolverhampton","E08000031","Urban minor conurbation",0,0,0,0,0,0,0,0,0,0,0,0
"2011","Wolverhampton","E08000031","Urban city and town",0,0,0,0,0,0,0,0,0,0,0,0
"2011","Wolverhampton","E08000031","Urban city and town in a sparse setting",0,0,0,0,0,0,0,0,0,0,0,0
"2011","Wolverhampton","E08000031","Rural (total)",0,0,0,0,0,0,0,0,0,0,0,0
"2011","Wolverhampton","E08000031","Rural town and fringe",0,0,0,0,0,0,0,0,0,0,0,0
"2011","Wolverhampton","E08000031","Rural town and fringe in a sparse setting",0,0,0,0,0,0,0,0,0,0,0,0
"2011","Wolverhampton","E08000031","Rural village",0,0,0,0,0,0,0,0,0,0,0,0
"2011","Wolverhampton","E08000031","Rural village in a sparse setting",0,0,0,0,0,0,0,0,0,0,0,0
"2011","Wolverhampton","E08000031","Rural hamlet and isolated dwellings",0,0,0,0,0,0,0,0,0,0,0,0
"2011","Wolverhampton","E08000031","Rural hamlet and isolated dwellings in a sparse setting",0,0,0,0,0,0,0,0,0,0,0,0
"2011","Bromsgrove","E07000234","Total",38290,30436,15554,14882,248,3819,1139,2680,3370,3035,335,417
"2011","Bromsgrove","E07000234","Urban (total)",30562,24228,12045,12183,203,3261,964,2297,2593,2354,239,277
"2011","Bromsgrove","E07000234","Urban major conurbation",7820,6670,3570,3100,39,535,165,370,509,450,59,67
"2011","Bromsgrove","E07000234","Urban minor conurbation",0,0,0,0,0,0,0,0,0,0,0,0
"2011","Bromsgrove","E07000234","Urban city and town",22742,17558,8475,9083,164,2726,799,1927,2084,1904,180,210
"2011","Bromsgrove","E07000234","Urban city and town in a sparse setting",0,0,0,0,0,0,0,0,0,0,0,0
"2011","Bromsgrove","E07000234","Rural (total)",7728,6208,3509,2699,45,558,175,383,777,681,96,140
"2011","Bromsgrove","E07000234","Rural town and fringe",2448,1860,954,906,11,325,96,229,212,188,24,40
"2011","Bromsgrove","E07000234","Rural town and fringe in a sparse setting",0,0,0,0,0,0,0,0,0,0,0,0
"2011","Bromsgrove","E07000234","Rural village",2452,1987,1137,850,23,152,52,100,250,213,37,40
"2011","Bromsgrove","E07000234","Rural village in a sparse setting",0,0,0,0,0,0,0,0,0,0,0,0
"2011","Bromsgrove","E07000234","Rural hamlet and isolated dwellings",2828,2361,1418,943,11,81,27,54,315,280,35,60
"2011","Bromsgrove","E07000234","Rural hamlet and isolated dwellings in a sparse setting",0,0,0,0,0,0,0,0,0,0,0,0
"2011","Malvern Hills","E07000235","Total",32212,23146,13680,9466,263,4547,558,3989,3720,3339,381,536
"2011","Malvern Hills","E07000235","Urban (total)",15572,10503,6076,4427,166,2835,367,2468,1872,1711,161,196
"2011","Malvern Hills","E07000235","Urban major conurbation",0,0,0,0,0,0,0,0,0,0,0,0
"2011","Malvern Hills","E07000235","Urban minor conurbation",0,0,0,0,0,0,0,0,0,0,0,0
"2011","Malvern Hills","E07000235","Urban city and town",15572,10503,6076,4427,166,2835,367,2468,1872,1711,161,196
"2011","Malvern Hills","E07000235","Urban city and town in a sparse setting",0,0,0,0,0,0,0,0,0,0,0,0
"2011","Malvern Hills","E07000235","Rural (total)",16640,12643,7604,5039,97,1712,191,1521,1848,1628,220,340
"2011","Malvern Hills","E07000235","Rural town and fringe",3755,2597,1565,1032,22,641,56,585,439,394,45,56
"2011","Malvern Hills","E07000235","Rural town and fringe in a sparse setting",0,0,0,0,0,0,0,0,0,0,0,0
"2011","Malvern Hills","E07000235","Rural village",6605,5082,2989,2093,53,722,89,633,635,546,89,113
"2011","Malvern Hills","E07000235","Rural village in a sparse setting",0,0,0,0,0,0,0,0,0,0,0,0
"2011","Malvern Hills","E07000235","Rural hamlet and isolated dwellings",6280,4964,3050,1914,22,349,46,303,774,688,86,171
"2011","Malvern Hills","E07000235","Rural hamlet and isolated dwellings in a sparse setting",0,0,0,0,0,0,0,0,0,0,0,0
"2011","Redditch","E07000236","Total",34722,22796,9204,13592,134,7351,5703,1648,4059,3700,359,382
"2011","Redditch","E07000236","Urban (total)",33677,21994,8845,13149,107,7298,5685,1613,3904,3561,343,374
"2011","Redditch","E07000236","Urban major conurbation",0,0,0,0,0,0,0,0,0,0,0,0
"2011","Redditch","E07000236","Urban minor conurbation",0,0,0,0,0,0,0,0,0,0,0,0
"2011","Redditch","E07000236","Urban city and town",33677,21994,8845,13149,107,7298,5685,1613,3904,3561,343,374
"2011","Redditch","E07000236","Urban city and town in a sparse setting",0,0,0,0,0,0,0,0,0,0,0,0
"2011","Redditch","E07000236","Rural (total)",1045,802,359,443,27,53,18,35,155,139,16,8
"2011","Redditch","E07000236","Rural town and fringe",433,302,92,210,23,32,5,27,74,70,4,2
"2011","Redditch","E07000236","Rural town and fringe in a sparse setting",0,0,0,0,0,0,0,0,0,0,0,0
"2011","Redditch","E07000236","Rural village",172,131,56,75,0,7,7,0,31,29,2,3
"2011","Redditch","E07000236","Rural village in a sparse setting",0,0,0,0,0,0,0,0,0,0,0,0
"2011","Redditch","E07000236","Rural hamlet and isolated dwellings",440,369,211,158,4,14,6,8,50,40,10,3
"2011","Redditch","E07000236","Rural hamlet and isolated dwellings in a sparse setting",0,0,0,0,0,0,0,0,0,0,0,0
"2011","Worcester","E07000237","Total",42042,27077,12181,14896,436,6438,2356,4082,7645,7093,552,446
"2011","Worcester","E07000237","Urban (total)",41994,27040,12161,14879,436,6434,2355,4079,7639,7088,551,445
"2011","Worcester","E07000237","Urban major conurbation",0,0,0,0,0,0,0,0,0,0,0,0
"2011","Worcester","E07000237","Urban minor conurbation",0,0,0,0,0,0,0,0,0,0,0,0
"2011","Worcester","E07000237","Urban city and town",41994,27040,12161,14879,436,6434,2355,4079,7639,7088,551,445
"2011","Worcester","E07000237","Urban city and town in a sparse setting",0,0,0,0,0,0,0,0,0,0,0,0
"2011","Worcester","E07000237","Rural (total)",48,37,20,17,0,4,1,3,6,5,1,1
"2011","Worcester","E07000237","Rural town and fringe",0,0,0,0,0,0,0,0,0,0,0,0
"2011","Worcester","E07000237","Rural town and fringe in a sparse setting",0,0,0,0,0,0,0,0,0,0,0,0
"2011","Worcester","E07000237","Rural village",0,0,0,0,0,0,0,0,0,0,0,0
"2011","Worcester","E07000237","Rural village in a sparse setting",0,0,0,0,0,0,0,0,0,0,0,0
"2011","Worcester","E07000237","Rural hamlet and isolated dwellings",48,37,20,17,0,4,1,3,6,5,1,1
"2011","Worcester","E07000237","Rural hamlet and isolated dwellings in a sparse setting",0,0,0,0,0,0,0,0,0,0,0,0
"2011","Wychavon","E07000238","Total",49466,35973,19158,16815,225,7166,771,6395,5419,4843,576,683
"2011","Wychavon","E07000238","Urban (total)",21363,14485,6973,7512,115,3863,439,3424,2685,2448,237,215
"2011","Wychavon","E07000238","Urban major conurbation",0,0,0,0,0,0,0,0,0,0,0,0
"2011","Wychavon","E07000238","Urban minor conurbation",0,0,0,0,0,0,0,0,0,0,0,0
"2011","Wychavon","E07000238","Urban city and town",21363,14485,6973,7512,115,3863,439,3424,2685,2448,237,215
"2011","Wychavon","E07000238","Urban city and town in a sparse setting",0,0,0,0,0,0,0,0,0,0,0,0
"2011","Wychavon","E07000238","Rural (total)",28103,21488,12185,9303,110,3303,332,2971,2734,2395,339,468
"2011","Wychavon","E07000238","Rural town and fringe",9890,7242,4123,3119,55,1494,152,1342,969,855,114,130
"2011","Wychavon","E07000238","Rural town and fringe in a sparse setting",0,0,0,0,0,0,0,0,0,0,0,0
"2011","Wychavon","E07000238","Rural village",13239,10289,5797,4492,40,1589,151,1438,1115,973,142,206
"2011","Wychavon","E07000238","Rural village in a sparse setting",0,0,0,0,0,0,0,0,0,0,0,0
"2011","Wychavon","E07000238","Rural hamlet and isolated dwellings",4974,3957,2265,1692,15,220,29,191,650,567,83,132
"2011","Wychavon","E07000238","Rural hamlet and isolated dwellings in a sparse setting",0,0,0,0,0,0,0,0,0,0,0,0
"2011","Wyre Forest","E07000239","Total",42985,30360,16196,14164,259,6205,2885,3320,5660,5155,505,501
"2011","Wyre Forest","E07000239","Urban (total)",33739,23318,11897,11421,221,5280,2517,2763,4575,4199,376,345
"2011","Wyre Forest","E07000239","Urban major conurbation",0,0,0,0,0,0,0,0,0,0,0,0
"2011","Wyre Forest","E07000239","Urban minor conurbation",0,0,0,0,0,0,0,0,0,0,0,0
"2011","Wyre Forest","E07000239","Urban city and town",33739,23318,11897,11421,221,5280,2517,2763,4575,4199,376,345
"2011","Wyre Forest","E07000239","Urban city and town in a sparse setting",0,0,0,0,0,0,0,0,0,0,0,0
"2011","Wyre Forest","E07000239","Rural (total)",9246,7042,4299,2743,38,925,368,557,1085,956,129,156
"2011","Wyre Forest","E07000239","Rural town and fringe",5557,4160,2384,1776,26,647,286,361,655,579,76,69
"2011","Wyre Forest","E07000239","Rural town and fringe in a sparse setting",0,0,0,0,0,0,0,0,0,0,0,0
"2011","Wyre Forest","E07000239","Rural village",951,763,465,298,3,99,35,64,77,68,9,9
"2011","Wyre Forest","E07000239","Rural village in a sparse setting",0,0,0,0,0,0,0,0,0,0,0,0
"2011","Wyre Forest","E07000239","Rural hamlet and isolated dwellings",2738,2119,1450,669,9,179,47,132,353,309,44,78
"2011","Wyre Forest","E07000239","Rural hamlet and isolated dwellings in a sparse setting",0,0,0,0,0,0,0,0,0,0,0,0
"2011","Bedford","E06000055","Total",63812,41937,20018,21919,665,10252,1155,9097,10110,9310,800,848
"2011","Bedford","E06000055","Urban (total)",43768,26286,12273,14013,409,8317,1010,7307,8245,7665,580,511
"2011","Bedford","E06000055","Urban major conurbation",0,0,0,0,0,0,0,0,0,0,0,0
"2011","Bedford","E06000055","Urban minor conurbation",0,0,0,0,0,0,0,0,0,0,0,0
"2011","Bedford","E06000055","Urban city and town",43768,26286,12273,14013,409,8317,1010,7307,8245,7665,580,511
"2011","Bedford","E06000055","Urban city and town in a sparse setting",0,0,0,0,0,0,0,0,0,0,0,0
"2011","Bedford","E06000055","Rural (total)",20044,15651,7745,7906,256,1935,145,1790,1865,1645,220,337
"2011","Bedford","E06000055","Rural town and fringe",10041,7956,3825,4131,148,1011,82,929,839,742,97,87
"2011","Bedford","E06000055","Rural town and fringe in a sparse setting",0,0,0,0,0,0,0,0,0,0,0,0
"2011","Bedford","E06000055","Rural village",6874,5259,2621,2638,81,679,53,626,670,594,76,185
"2011","Bedford","E06000055","Rural village in a sparse setting",0,0,0,0,0,0,0,0,0,0,0,0
"2011","Bedford","E06000055","Rural hamlet and isolated dwellings",3129,2436,1299,1137,27,245,10,235,356,309,47,65
"2011","Bedford","E06000055","Rural hamlet and isolated dwellings in a sparse setting",0,0,0,0,0,0,0,0,0,0,0,0
"2011","Central Bedfordshire","E06000056","Total",104399,75743,33039,42704,874,13981,5464,8517,12612,10973,1639,1189
"2011","Central Bedfordshire","E06000056","Urban (total)",63701,45071,18864,26207,588,9435,4226,5209,7925,7197,728,682
"2011","Central Bedfordshire","E06000056","Urban major conurbation",0,0,0,0,0,0,0,0,0,0,0,0
"2011","Central Bedfordshire","E06000056","Urban minor conurbation",0,0,0,0,0,0,0,0,0,0,0,0
"2011","Central Bedfordshire","E06000056","Urban city and town",63701,45071,18864,26207,588,9435,4226,5209,7925,7197,728,682
"2011","Central Bedfordshire","E06000056","Urban city and town in a sparse setting",0,0,0,0,0,0,0,0,0,0,0,0
"2011","Central Bedfordshire","E06000056","Rural (total)",40698,30672,14175,16497,286,4546,1238,3308,4687,3776,911,507
"2011","Central Bedfordshire","E06000056","Rural town and fringe",26363,20097,8799,11298,225,3016,779,2237,2766,2290,476,259
"2011","Central Bedfordshire","E06000056","Rural town and fringe in a sparse setting",0,0,0,0,0,0,0,0,0,0,0,0
"2011","Central Bedfordshire","E06000056","Rural village",10867,8026,3976,4050,50,1303,384,919,1322,968,354,166
"2011","Central Bedfordshire","E06000056","Rural village in a sparse setting",0,0,0,0,0,0,0,0,0,0,0,0
"2011","Central Bedfordshire","E06000056","Rural hamlet and isolated dwellings",3468,2549,1400,1149,11,227,75,152,599,518,81,82
"2011","Central Bedfordshire","E06000056","Rural hamlet and isolated dwellings in a sparse setting",0,0,0,0,0,0,0,0,0,0,0,0
"2011","Luton","E06000032","Total",74293,44696,18619,26077,288,11715,7973,3742,16816,15802,1014,778
"2011","Luton","E06000032","Urban (total)",74293,44696,18619,26077,288,11715,7973,3742,16816,15802,1014,778
"2011","Luton","E06000032","Urban major conurbation",0,0,0,0,0,0,0,0,0,0,0,0
"2011","Luton","E06000032","Urban minor conurbation",0,0,0,0,0,0,0,0,0,0,0,0
"2011","Luton","E06000032","Urban city and town",74293,44696,18619,26077,288,11715,7973,3742,16816,15802,1014,778
"2011","Luton","E06000032","Urban city and town in a sparse setting",0,0,0,0,0,0,0,0,0,0,0,0
"2011","Luton","E06000032","Rural (total)",0,0,0,0,0,0,0,0,0,0,0,0
"2011","Luton","E06000032","Rural town and fringe",0,0,0,0,0,0,0,0,0,0,0,0
"2011","Luton","E06000032","Rural town and fringe in a sparse setting",0,0,0,0,0,0,0,0,0,0,0,0
"2011","Luton","E06000032","Rural village",0,0,0,0,0,0,0,0,0,0,0,0
"2011","Luton","E06000032","Rural village in a sparse setting",0,0,0,0,0,0,0,0,0,0,0,0
"2011","Luton","E06000032","Rural hamlet and isolated dwellings",0,0,0,0,0,0,0,0,0,0,0,0
"2011","Luton","E06000032","Rural hamlet and isolated dwellings in a sparse setting",0,0,0,0,0,0,0,0,0,0,0,0
"2011","Peterborough","E06000031","Total",74023,43877,19134,24743,689,14434,4751,9683,14168,12855,1313,855
"2011","Peterborough","E06000031","Urban (total)",65301,37672,16194,21478,612,13524,4451,9073,12798,11892,906,695
"2011","Peterborough","E06000031","Urban major conurbation",0,0,0,0,0,0,0,0,0,0,0,0
"2011","Peterborough","E06000031","Urban minor conurbation",0,0,0,0,0,0,0,0,0,0,0,0
"2011","Peterborough","E06000031","Urban city and town",65301,37672,16194,21478,612,13524,4451,9073,12798,11892,906,695
"2011","Peterborough","E06000031","Urban city and town in a sparse setting",0,0,0,0,0,0,0,0,0,0,0,0
"2011","Peterborough","E06000031","Rural (total)",8722,6205,2940,3265,77,910,300,610,1370,963,407,160
"2011","Peterborough","E06000031","Rural town and fringe",5378,3632,1568,2064,63,632,204,428,970,611,359,81
"2011","Peterborough","E06000031","Rural town and fringe in a sparse setting",0,0,0,0,0,0,0,0,0,0,0,0
"2011","Peterborough","E06000031","Rural village",2703,2114,1149,965,12,232,70,162,287,259,28,58
"2011","Peterborough","E06000031","Rural village in a sparse setting",0,0,0,0,0,0,0,0,0,0,0,0
"2011","Peterborough","E06000031","Rural hamlet and isolated dwellings",641,459,223,236,2,46,26,20,113,93,20,21
"2011","Peterborough","E06000031","Rural hamlet and isolated dwellings in a sparse setting",0,0,0,0,0,0,0,0,0,0,0,0
"2011","Southend-on-Sea","E06000033","Total",74678,48666,22960,25706,306,8597,5079,3518,16439,15472,967,670
"2011","Southend-on-Sea","E06000033","Urban (total)",74678,48666,22960,25706,306,8597,5079,3518,16439,15472,967,670
"2011","Southend-on-Sea","E06000033","Urban major conurbation",0,0,0,0,0,0,0,0,0,0,0,0
"2011","Southend-on-Sea","E06000033","Urban minor conurbation",0,0,0,0,0,0,0,0,0,0,0,0
"2011","Southend-on-Sea","E06000033","Urban city and town",74678,48666,22960,25706,306,8597,5079,3518,16439,15472,967,670
"2011","Southend-on-Sea","E06000033","Urban city and town in a sparse setting",0,0,0,0,0,0,0,0,0,0,0,0
"2011","Southend-on-Sea","E06000033","Rural (total)",0,0,0,0,0,0,0,0,0,0,0,0
"2011","Southend-on-Sea","E06000033","Rural town and fringe",0,0,0,0,0,0,0,0,0,0,0,0
"2011","Southend-on-Sea","E06000033","Rural town and fringe in a sparse setting",0,0,0,0,0,0,0,0,0,0,0,0
"2011","Southend-on-Sea","E06000033","Rural village",0,0,0,0,0,0,0,0,0,0,0,0
"2011","Southend-on-Sea","E06000033","Rural village in a sparse setting",0,0,0,0,0,0,0,0,0,0,0,0
"2011","Southend-on-Sea","E06000033","Rural hamlet and isolated dwellings",0,0,0,0,0,0,0,0,0,0,0,0
"2011","Southend-on-Sea","E06000033","Rural hamlet and isolated dwellings in a sparse setting",0,0,0,0,0,0,0,0,0,0,0,0
"2011","Thurrock","E06000034","Total",62353,41278,15899,25379,302,11503,10055,1448,8772,8220,552,498
"2011","Thurrock","E06000034","Urban (total)",54549,35495,13581,21914,273,10472,9136,1336,7898,7439,459,411
"2011","Thurrock","E06000034","Urban major conurbation",41469,25692,8994,16698,202,8829,7857,972,6439,6089,350,307
"2011","Thurrock","E06000034","Urban minor conurbation",0,0,0,0,0,0,0,0,0,0,0,0
"2011","Thurrock","E06000034","Urban city and town",13080,9803,4587,5216,71,1643,1279,364,1459,1350,109,104
"2011","Thurrock","E06000034","Urban city and town in a sparse setting",0,0,0,0,0,0,0,0,0,0,0,0
"2011","Thurrock","E06000034","Rural (total)",7804,5783,2318,3465,29,1031,919,112,874,781,93,87
"2011","Thurrock","E06000034","Rural town and fringe",6528,4714,1841,2873,21,1004,900,104,727,654,73,62
"2011","Thurrock","E06000034","Rural town and fringe in a sparse setting",0,0,0,0,0,0,0,0,0,0,0,0
"2011","Thurrock","E06000034","Rural village",1038,889,374,515,8,26,18,8,99,81,18,16
"2011","Thurrock","E06000034","Rural village in a sparse setting",0,0,0,0,0,0,0,0,0,0,0,0
"2011","Thurrock","E06000034","Rural hamlet and isolated dwellings",238,180,103,77,0,1,1,0,48,46,2,9
"2011","Thurrock","E06000034","Rural hamlet and isolated dwellings in a sparse setting",0,0,0,0,0,0,0,0,0,0,0,0
"2011","Cambridge","E07000008","Total",46714,22171,11639,10532,526,11023,7109,3914,12258,11170,1088,736
"2011","Cambridge","E07000008","Urban (total)",46565,22066,11564,10502,526,11015,7105,3910,12225,11151,1074,733
"2011","Cambridge","E07000008","Urban major conurbation",0,0,0,0,0,0,0,0,0,0,0,0
"2011","Cambridge","E07000008","Urban minor conurbation",0,0,0,0,0,0,0,0,0,0,0,0
"2011","Cambridge","E07000008","Urban city and town",46565,22066,11564,10502,526,11015,7105,3910,12225,11151,1074,733
"2011","Cambridge","E07000008","Urban city and town in a sparse setting",0,0,0,0,0,0,0,0,0,0,0,0
"2011","Cambridge","E07000008","Rural (total)",149,105,75,30,0,8,4,4,33,19,14,3
"2011","Cambridge","E07000008","Rural town and fringe",149,105,75,30,0,8,4,4,33,19,14,3
"2011","Cambridge","E07000008","Rural town and fringe in a sparse setting",0,0,0,0,0,0,0,0,0,0,0,0
"2011","Cambridge","E07000008","Rural village",0,0,0,0,0,0,0,0,0,0,0,0
"2011","Cambridge","E07000008","Rural village in a sparse setting",0,0,0,0,0,0,0,0,0,0,0,0
"2011","Cambridge","E07000008","Rural hamlet and isolated dwellings",0,0,0,0,0,0,0,0,0,0,0,0
"2011","Cambridge","E07000008","Rural hamlet and isolated dwellings in a sparse setting",0,0,0,0,0,0,0,0,0,0,0,0
"2011","East Cambridgeshire","E07000009","Total",34614,23719,11145,12574,506,4944,457,4487,4576,4144,432,869
"2011","East Cambridgeshire","E07000009","Urban (total)",8990,5819,2716,3103,209,1226,102,1124,1514,1407,107,222
"2011","East Cambridgeshire","E07000009","Urban major conurbation",0,0,0,0,0,0,0,0,0,0,0,0
"2011","East Cambridgeshire","E07000009","Urban minor conurbation",0,0,0,0,0,0,0,0,0,0,0,0
"2011","East Cambridgeshire","E07000009","Urban city and town",8990,5819,2716,3103,209,1226,102,1124,1514,1407,107,222
"2011","East Cambridgeshire","E07000009","Urban city and town in a sparse setting",0,0,0,0,0,0,0,0,0,0,0,0
"2011","East Cambridgeshire","E07000009","Rural (total)",25624,17900,8429,9471,297,3718,355,3363,3062,2737,325,647
"2011","East Cambridgeshire","E07000009","Rural town and fringe",16548,11553,5246,6307,249,2517,225,2292,1995,1829,166,234
"2011","East Cambridgeshire","E07000009","Rural town and fringe in a sparse setting",0,0,0,0,0,0,0,0,0,0,0,0
"2011","East Cambridgeshire","E07000009","Rural village",6466,4472,2213,2259,33,948,84,864,712,620,92,301
"2011","East Cambridgeshire","E07000009","Rural village in a sparse setting",0,0,0,0,0,0,0,0,0,0,0,0
"2011","East Cambridgeshire","E07000009","Rural hamlet and isolated dwellings",2610,1875,970,905,15,253,46,207,355,288,67,112
"2011","East Cambridgeshire","E07000009","Rural hamlet and isolated dwellings in a sparse setting",0,0,0,0,0,0,0,0,0,0,0,0
"2011","Fenland","E07000010","Total",40620,28436,14490,13946,205,5054,895,4159,6341,5802,539,584
"2011","Fenland","E07000010","Urban (total)",31539,21293,10960,10333,165,4309,748,3561,5368,4960,408,404
"2011","Fenland","E07000010","Urban major conurbation",0,0,0,0,0,0,0,0,0,0,0,0
"2011","Fenland","E07000010","Urban minor conurbation",0,0,0,0,0,0,0,0,0,0,0,0
"2011","Fenland","E07000010","Urban city and town",31539,21293,10960,10333,165,4309,748,3561,5368,4960,408,404
"2011","Fenland","E07000010","Urban city and town in a sparse setting",0,0,0,0,0,0,0,0,0,0,0,0
"2011","Fenland","E07000010","Rural (total)",9081,7143,3530,3613,40,745,147,598,973,842,131,180
"2011","Fenland","E07000010","Rural town and fringe",2561,2075,978,1097,7,178,38,140,258,231,27,43
"2011","Fenland","E07000010","Rural town and fringe in a sparse setting",0,0,0,0,0,0,0,0,0,0,0,0
"2011","Fenland","E07000010","Rural village",4257,3269,1667,1602,24,435,70,365,452,398,54,77
"2011","Fenland","E07000010","Rural village in a sparse setting",0,0,0,0,0,0,0,0,0,0,0,0
"2011","Fenland","E07000010","Rural hamlet and isolated dwellings",2263,1799,885,914,9,132,39,93,263,213,50,60
"2011","Fenland","E07000010","Rural hamlet and isolated dwellings in a sparse setting",0,0,0,0,0,0,0,0,0,0,0,0
"2011","Huntingdonshire","E07000011","Total",69333,49398,22171,27227,508,8939,1811,7128,9770,8636,1134,718
"2011","Huntingdonshire","E07000011","Urban (total)",31630,21118,9117,12001,317,5012,1041,3971,4918,4490,428,265
"2011","Huntingdonshire","E07000011","Urban major conurbation",0,0,0,0,0,0,0,0,0,0,0,0
"2011","Huntingdonshire","E07000011","Urban minor conurbation",0,0,0,0,0,0,0,0,0,0,0,0
"2011","Huntingdonshire","E07000011","Urban city and town",31630,21118,9117,12001,317,5012,1041,3971,4918,4490,428,265
"2011","Huntingdonshire","E07000011","Urban city and town in a sparse setting",0,0,0,0,0,0,0,0,0,0,0,0
"2011","Huntingdonshire","E07000011","Rural (total)",37703,28280,13054,15226,191,3927,770,3157,4852,4146,706,453
"2011","Huntingdonshire","E07000011","Rural town and fringe",25125,18573,8170,10403,147,2897,542,2355,3250,2814,436,258
"2011","Huntingdonshire","E07000011","Rural town and fringe in a sparse setting",0,0,0,0,0,0,0,0,0,0,0,0
"2011","Huntingdonshire","E07000011","Rural village",10019,7866,3917,3949,35,812,170,642,1165,984,181,141
"2011","Huntingdonshire","E07000011","Rural village in a sparse setting",0,0,0,0,0,0,0,0,0,0,0,0
"2011","Huntingdonshire","E07000011","Rural hamlet and isolated dwellings",2559,1841,967,874,9,218,58,160,437,348,89,54
"2011","Huntingdonshire","E07000011","Rural hamlet and isolated dwellings in a sparse setting",0,0,0,0,0,0,0,0,0,0,0,0
"2011","South Cambridgeshire","E07000012","Total",59960,42129,20759,21370,1258,8546,5464,3082,7174,6213,961,853
"2011","South Cambridgeshire","E07000012","Urban (total)",14162,9403,5072,4331,353,2065,1201,864,2187,2028,159,154
"2011","South Cambridgeshire","E07000012","Urban major conurbation",0,0,0,0,0,0,0,0,0,0,0,0
"2011","South Cambridgeshire","E07000012","Urban minor conurbation",0,0,0,0,0,0,0,0,0,0,0,0
"2011","South Cambridgeshire","E07000012","Urban city and town",14162,9403,5072,4331,353,2065,1201,864,2187,2028,159,154
"2011","South Cambridgeshire","E07000012","Urban city and town in a sparse setting",0,0,0,0,0,0,0,0,0,0,0,0
"2011","South Cambridgeshire","E07000012","Rural (total)",45798,32726,15687,17039,905,6481,4263,2218,4987,4185,802,699
"2011","South Cambridgeshire","E07000012","Rural town and fringe",27857,19862,8913,10949,688,3963,2436,1527,3012,2556,456,332
"2011","South Cambridgeshire","E07000012","Rural town and fringe in a sparse setting",0,0,0,0,0,0,0,0,0,0,0,0
"2011","South Cambridgeshire","E07000012","Rural village",14739,10576,5637,4939,176,2119,1589,530,1578,1278,300,290
"2011","South Cambridgeshire","E07000012","Rural village in a sparse setting",0,0,0,0,0,0,0,0,0,0,0,0
"2011","South Cambridgeshire","E07000012","Rural hamlet and isolated dwellings",3202,2288,1137,1151,41,399,238,161,397,351,46,77
"2011","South Cambridgeshire","E07000012","Rural hamlet and isolated dwellings in a sparse setting",0,0,0,0,0,0,0,0,0,0,0,0
"2011","Basildon","E07000066","Total",72746,47972,21037,26935,720,15976,10309,5667,7448,6825,623,630
"2011","Basildon","E07000066","Urban (total)",72356,47634,20799,26835,714,15964,10298,5666,7421,6806,615,623
"2011","Basildon","E07000066","Urban major conurbation",0,0,0,0,0,0,0,0,0,0,0,0
"2011","Basildon","E07000066","Urban minor conurbation",0,0,0,0,0,0,0,0,0,0,0,0
"2011","Basildon","E07000066","Urban city and town",72356,47634,20799,26835,714,15964,10298,5666,7421,6806,615,623
"2011","Basildon","E07000066","Urban city and town in a sparse setting",0,0,0,0,0,0,0,0,0,0,0,0
"2011","Basildon","E07000066","Rural (total)",390,338,238,100,6,12,11,1,27,19,8,7
"2011","Basildon","E07000066","Rural town and fringe",168,154,148,6,4,5,5,0,4,2,2,1
"2011","Basildon","E07000066","Rural town and fringe in a sparse setting",0,0,0,0,0,0,0,0,0,0,0,0
"2011","Basildon","E07000066","Rural village",0,0,0,0,0,0,0,0,0,0,0,0
"2011","Basildon","E07000066","Rural village in a sparse setting",0,0,0,0,0,0,0,0,0,0,0,0
"2011","Basildon","E07000066","Rural hamlet and isolated dwellings",222,184,90,94,2,7,6,1,23,17,6,6
"2011","Basildon","E07000066","Rural hamlet and isolated dwellings in a sparse setting",0,0,0,0,0,0,0,0,0,0,0,0
"2011","Braintree","E07000067","Total",61043,41872,18609,23263,362,10055,2378,7677,8083,7332,751,671
"2011","Braintree","E07000067","Urban (total)",37789,24848,10149,14699,267,6973,1658,5315,5398,4960,438,303
"2011","Braintree","E07000067","Urban major conurbation",0,0,0,0,0,0,0,0,0,0,0,0
"2011","Braintree","E07000067","Urban minor conurbation",0,0,0,0,0,0,0,0,0,0,0,0
"2011","Braintree","E07000067","Urban city and town",37789,24848,10149,14699,267,6973,1658,5315,5398,4960,438,303
"2011","Braintree","E07000067","Urban city and town in a sparse setting",0,0,0,0,0,0,0,0,0,0,0,0
"2011","Braintree","E07000067","Rural (total)",23254,17024,8460,8564,95,3082,720,2362,2685,2372,313,368
"2011","Braintree","E07000067","Rural town and fringe",11702,8368,3890,4478,39,1894,470,1424,1268,1156,112,133
"2011","Braintree","E07000067","Rural town and fringe in a sparse setting",0,0,0,0,0,0,0,0,0,0,0,0
"2011","Braintree","E07000067","Rural village",6862,5213,2740,2473,34,820,179,641,694,620,74,101
"2011","Braintree","E07000067","Rural village in a sparse setting",0,0,0,0,0,0,0,0,0,0,0,0
"2011","Braintree","E07000067","Rural hamlet and isolated dwellings",4690,3443,1830,1613,22,368,71,297,723,596,127,134
"2011","Braintree","E07000067","Rural hamlet and isolated dwellings in a sparse setting",0,0,0,0,0,0,0,0,0,0,0,0
"2011","Brentwood","E07000068","Total",30646,23028,11634,11394,194,3586,2703,883,3452,3148,304,386
"2011","Brentwood","E07000068","Urban (total)",22328,16190,7832,8358,167,2905,2198,707,2808,2584,224,258
"2011","Brentwood","E07000068","Urban major conurbation",0,0,0,0,0,0,0,0,0,0,0,0
"2011","Brentwood","E07000068","Urban minor conurbation",0,0,0,0,0,0,0,0,0,0,0,0
"2011","Brentwood","E07000068","Urban city and town",22328,16190,7832,8358,167,2905,2198,707,2808,2584,224,258
"2011","Brentwood","E07000068","Urban city and town in a sparse setting",0,0,0,0,0,0,0,0,0,0,0,0
"2011","Brentwood","E07000068","Rural (total)",8318,6838,3802,3036,27,681,505,176,644,564,80,128
"2011","Brentwood","E07000068","Rural town and fringe",5292,4385,2453,1932,15,439,342,97,391,352,39,62
"2011","Brentwood","E07000068","Rural town and fringe in a sparse setting",0,0,0,0,0,0,0,0,0,0,0,0
"2011","Brentwood","E07000068","Rural village",1229,988,513,475,7,153,106,47,57,49,8,24
"2011","Brentwood","E07000068","Rural village in a sparse setting",0,0,0,0,0,0,0,0,0,0,0,0
"2011","Brentwood","E07000068","Rural hamlet and isolated dwellings",1797,1465,836,629,5,89,57,32,196,163,33,42
"2011","Brentwood","E07000068","Rural hamlet and isolated dwellings in a sparse setting",0,0,0,0,0,0,0,0,0,0,0,0
"2011","Castle Point","E07000069","Total",36440,30101,15691,14410,103,1949,1453,496,3968,3584,384,319
"2011","Castle Point","E07000069","Urban (total)",36440,30101,15691,14410,103,1949,1453,496,3968,3584,384,319
"2011","Castle Point","E07000069","Urban major conurbation",0,0,0,0,0,0,0,0,0,0,0,0
"2011","Castle Point","E07000069","Urban minor conurbation",0,0,0,0,0,0,0,0,0,0,0,0
"2011","Castle Point","E07000069","Urban city and town",36440,30101,15691,14410,103,1949,1453,496,3968,3584,384,319
"2011","Castle Point","E07000069","Urban city and town in a sparse setting",0,0,0,0,0,0,0,0,0,0,0,0
"2011","Castle Point","E07000069","Rural (total)",0,0,0,0,0,0,0,0,0,0,0,0
"2011","Castle Point","E07000069","Rural town and fringe",0,0,0,0,0,0,0,0,0,0,0,0
"2011","Castle Point","E07000069","Rural town and fringe in a sparse setting",0,0,0,0,0,0,0,0,0,0,0,0
"2011","Castle Point","E07000069","Rural village",0,0,0,0,0,0,0,0,0,0,0,0
"2011","Castle Point","E07000069","Rural village in a sparse setting",0,0,0,0,0,0,0,0,0,0,0,0
"2011","Castle Point","E07000069","Rural hamlet and isolated dwellings",0,0,0,0,0,0,0,0,0,0,0,0
"2011","Castle Point","E07000069","Rural hamlet and isolated dwellings in a sparse setting",0,0,0,0,0,0,0,0,0,0,0,0
"2011","Chelmsford","E07000070","Total",69667,50978,23696,27282,450,9120,1456,7664,8349,7621,728,770
"2011","Chelmsford","E07000070","Urban (total)",56210,40547,18142,22405,390,7566,1233,6333,7154,6587,567,553
"2011","Chelmsford","E07000070","Urban major conurbation",0,0,0,0,0,0,0,0,0,0,0,0
"2011","Chelmsford","E07000070","Urban minor conurbation",0,0,0,0,0,0,0,0,0,0,0,0
"2011","Chelmsford","E07000070","Urban city and town",56210,40547,18142,22405,390,7566,1233,6333,7154,6587,567,553
"2011","Chelmsford","E07000070","Urban city and town in a sparse setting",0,0,0,0,0,0,0,0,0,0,0,0
"2011","Chelmsford","E07000070","Rural (total)",13457,10431,5554,4877,60,1554,223,1331,1195,1034,161,217
"2011","Chelmsford","E07000070","Rural town and fringe",6495,4853,2465,2388,30,1016,138,878,527,466,61,69
"2011","Chelmsford","E07000070","Rural town and fringe in a sparse setting",0,0,0,0,0,0,0,0,0,0,0,0
"2011","Chelmsford","E07000070","Rural village",3910,3121,1699,1422,9,399,67,332,316,268,48,65
"2011","Chelmsford","E07000070","Rural village in a sparse setting",0,0,0,0,0,0,0,0,0,0,0,0
"2011","Chelmsford","E07000070","Rural hamlet and isolated dwellings",3052,2457,1390,1067,21,139,18,121,352,300,52,83
"2011","Chelmsford","E07000070","Rural hamlet and isolated dwellings in a sparse setting",0,0,0,0,0,0,0,0,0,0,0,0
"2011","Colchester","E07000071","Total",71634,47507,22840,24667,325,9669,5894,3775,13390,11689,1701,743
"2011","Colchester","E07000071","Urban (total)",51107,31062,13797,17265,255,8194,4804,3390,11102,9704,1398,494
"2011","Colchester","E07000071","Urban major conurbation",0,0,0,0,0,0,0,0,0,0,0,0
"2011","Colchester","E07000071","Urban minor conurbation",0,0,0,0,0,0,0,0,0,0,0,0
"2011","Colchester","E07000071","Urban city and town",51107,31062,13797,17265,255,8194,4804,3390,11102,9704,1398,494
"2011","Colchester","E07000071","Urban city and town in a sparse setting",0,0,0,0,0,0,0,0,0,0,0,0
"2011","Colchester","E07000071","Rural (total)",20527,16445,9043,7402,70,1475,1090,385,2288,1985,303,249
"2011","Colchester","E07000071","Rural town and fringe",13724,11030,6100,4930,45,913,645,268,1607,1425,182,129
"2011","Colchester","E07000071","Rural town and fringe in a sparse setting",0,0,0,0,0,0,0,0,0,0,0,0
"2011","Colchester","E07000071","Rural village",4349,3519,1949,1570,19,420,349,71,333,294,39,58
"2011","Colchester","E07000071","Rural village in a sparse setting",0,0,0,0,0,0,0,0,0,0,0,0
"2011","Colchester","E07000071","Rural hamlet and isolated dwellings",2454,1896,994,902,6,142,96,46,348,266,82,62
"2011","Colchester","E07000071","Rural hamlet and isolated dwellings in a sparse setting",0,0,0,0,0,0,0,0,0,0,0,0
"2011","Epping Forest","E07000072","Total",51991,37565,18070,19495,206,7803,6208,1595,5742,5307,435,675
"2011","Epping Forest","E07000072","Urban (total)",38334,27125,12648,14477,152,6089,4864,1225,4498,4179,319,470
"2011","Epping Forest","E07000072","Urban major conurbation",30380,21243,9624,11619,130,5125,4195,930,3532,3291,241,350
"2011","Epping Forest","E07000072","Urban minor conurbation",0,0,0,0,0,0,0,0,0,0,0,0
"2011","Epping Forest","E07000072","Urban city and town",7954,5882,3024,2858,22,964,669,295,966,888,78,120
"2011","Epping Forest","E07000072","Urban city and town in a sparse setting",0,0,0,0,0,0,0,0,0,0,0,0
"2011","Epping Forest","E07000072","Rural (total)",13657,10440,5422,5018,54,1714,1344,370,1244,1128,116,205
"2011","Epping Forest","E07000072","Rural town and fringe",7477,5618,2820,2798,21,1157,869,288,613,567,46,68
"2011","Epping Forest","E07000072","Rural town and fringe in a sparse setting",0,0,0,0,0,0,0,0,0,0,0,0
"2011","Epping Forest","E07000072","Rural village",3178,2466,1363,1103,15,394,338,56,236,217,19,67
"2011","Epping Forest","E07000072","Rural village in a sparse setting",0,0,0,0,0,0,0,0,0,0,0,0
"2011","Epping Forest","E07000072","Rural hamlet and isolated dwellings",3002,2356,1239,1117,18,163,137,26,395,344,51,70
"2011","Epping Forest","E07000072","Rural hamlet and isolated dwellings in a sparse setting",0,0,0,0,0,0,0,0,0,0,0,0
"2011","Harlow","E07000073","Total",34620,19429,7351,12078,326,10808,9327,1481,3756,3474,282,301
"2011","Harlow","E07000073","Urban (total)",34620,19429,7351,12078,326,10808,9327,1481,3756,3474,282,301
"2011","Harlow","E07000073","Urban major conurbation",0,0,0,0,0,0,0,0,0,0,0,0
"2011","Harlow","E07000073","Urban minor conurbation",0,0,0,0,0,0,0,0,0,0,0,0
"2011","Harlow","E07000073","Urban city and town",34620,19429,7351,12078,326,10808,9327,1481,3756,3474,282,301
"2011","Harlow","E07000073","Urban city and town in a sparse setting",0,0,0,0,0,0,0,0,0,0,0,0
"2011","Harlow","E07000073","Rural (total)",0,0,0,0,0,0,0,0,0,0,0,0
"2011","Harlow","E07000073","Rural town and fringe",0,0,0,0,0,0,0,0,0,0,0,0
"2011","Harlow","E07000073","Rural town and fringe in a sparse setting",0,0,0,0,0,0,0,0,0,0,0,0
"2011","Harlow","E07000073","Rural village",0,0,0,0,0,0,0,0,0,0,0,0
"2011","Harlow","E07000073","Rural village in a sparse setting",0,0,0,0,0,0,0,0,0,0,0,0
"2011","Harlow","E07000073","Rural hamlet and isolated dwellings",0,0,0,0,0,0,0,0,0,0,0,0
"2011","Harlow","E07000073","Rural hamlet and isolated dwellings in a sparse setting",0,0,0,0,0,0,0,0,0,0,0,0
"2011","Maldon","E07000074","Total",25817,20251,10314,9937,97,2685,157,2528,2493,2208,285,291
"2011","Maldon","E07000074","Urban (total)",9165,6802,3341,3461,47,1293,71,1222,948,861,87,75
"2011","Maldon","E07000074","Urban major conurbation",0,0,0,0,0,0,0,0,0,0,0,0
"2011","Maldon","E07000074","Urban minor conurbation",0,0,0,0,0,0,0,0,0,0,0,0
"2011","Maldon","E07000074","Urban city and town",9165,6802,3341,3461,47,1293,71,1222,948,861,87,75
"2011","Maldon","E07000074","Urban city and town in a sparse setting",0,0,0,0,0,0,0,0,0,0,0,0
"2011","Maldon","E07000074","Rural (total)",16652,13449,6973,6476,50,1392,86,1306,1545,1347,198,216
"2011","Maldon","E07000074","Rural town and fringe",8773,6994,3503,3491,26,763,48,715,893,782,111,97
"2011","Maldon","E07000074","Rural town and fringe in a sparse setting",0,0,0,0,0,0,0,0,0,0,0,0
"2011","Maldon","E07000074","Rural village",5371,4467,2376,2091,20,438,24,414,383,333,50,63
"2011","Maldon","E07000074","Rural village in a sparse setting",0,0,0,0,0,0,0,0,0,0,0,0
"2011","Maldon","E07000074","Rural hamlet and isolated dwellings",2508,1988,1094,894,4,191,14,177,269,232,37,56
"2011","Maldon","E07000074","Rural hamlet and isolated dwellings in a sparse setting",0,0,0,0,0,0,0,0,0,0,0,0
"2011","Rochford","E07000075","Total",33564,27822,13927,13895,79,2547,406,2141,2844,2535,309,272
"2011","Rochford","E07000075","Urban (total)",29045,24326,12223,12103,56,2084,311,1773,2368,2148,220,211
"2011","Rochford","E07000075","Urban major conurbation",0,0,0,0,0,0,0,0,0,0,0,0
"2011","Rochford","E07000075","Urban minor conurbation",0,0,0,0,0,0,0,0,0,0,0,0
"2011","Rochford","E07000075","Urban city and town",29045,24326,12223,12103,56,2084,311,1773,2368,2148,220,211
"2011","Rochford","E07000075","Urban city and town in a sparse setting",0,0,0,0,0,0,0,0,0,0,0,0
"2011","Rochford","E07000075","Rural (total)",4519,3496,1704,1792,23,463,95,368,476,387,89,61
"2011","Rochford","E07000075","Rural town and fringe",1873,1432,647,785,9,261,56,205,153,129,24,18
"2011","Rochford","E07000075","Rural town and fringe in a sparse setting",0,0,0,0,0,0,0,0,0,0,0,0
"2011","Rochford","E07000075","Rural village",1639,1318,665,653,10,156,28,128,142,131,11,13
"2011","Rochford","E07000075","Rural village in a sparse setting",0,0,0,0,0,0,0,0,0,0,0,0
"2011","Rochford","E07000075","Rural hamlet and isolated dwellings",1007,746,392,354,4,46,11,35,181,127,54,30
"2011","Rochford","E07000075","Rural hamlet and isolated dwellings in a sparse setting",0,0,0,0,0,0,0,0,0,0,0,0
"2011","Tendring","E07000076","Total",62105,45752,27696,18056,238,5243,2988,2255,10064,9210,854,808
"2011","Tendring","E07000076","Urban (total)",40280,28693,17712,10981,173,3807,1984,1823,7116,6543,573,491
"2011","Tendring","E07000076","Urban major conurbation",0,0,0,0,0,0,0,0,0,0,0,0
"2011","Tendring","E07000076","Urban minor conurbation",0,0,0,0,0,0,0,0,0,0,0,0
"2011","Tendring","E07000076","Urban city and town",40280,28693,17712,10981,173,3807,1984,1823,7116,6543,573,491
"2011","Tendring","E07000076","Urban city and town in a sparse setting",0,0,0,0,0,0,0,0,0,0,0,0
"2011","Tendring","E07000076","Rural (total)",21825,17059,9984,7075,65,1436,1004,432,2948,2667,281,317
"2011","Tendring","E07000076","Rural town and fringe",14431,10922,6477,4445,42,1023,701,322,2268,2084,184,176
"2011","Tendring","E07000076","Rural town and fringe in a sparse setting",0,0,0,0,0,0,0,0,0,0,0,0
"2011","Tendring","E07000076","Rural village",5244,4362,2533,1829,12,329,254,75,459,390,69,82
"2011","Tendring","E07000076","Rural village in a sparse setting",0,0,0,0,0,0,0,0,0,0,0,0
"2011","Tendring","E07000076","Rural hamlet and isolated dwellings",2150,1775,974,801,11,84,49,35,221,193,28,59
"2011","Tendring","E07000076","Rural hamlet and isolated dwellings in a sparse setting",0,0,0,0,0,0,0,0,0,0,0,0
"2011","Uttlesford","E07000077","Total",31316,22425,10668,11757,321,3961,2660,1301,4108,3608,500,501
"2011","Uttlesford","E07000077","Urban (total)",6402,4336,2193,2143,64,1032,564,468,878,787,91,92
"2011","Uttlesford","E07000077","Urban major conurbation",0,0,0,0,0,0,0,0,0,0,0,0
"2011","Uttlesford","E07000077","Urban minor conurbation",0,0,0,0,0,0,0,0,0,0,0,0
"2011","Uttlesford","E07000077","Urban city and town",6402,4336,2193,2143,64,1032,564,468,878,787,91,92
"2011","Uttlesford","E07000077","Urban city and town in a sparse setting",0,0,0,0,0,0,0,0,0,0,0,0
"2011","Uttlesford","E07000077","Rural (total)",24914,18089,8475,9614,257,2929,2096,833,3230,2821,409,409
"2011","Uttlesford","E07000077","Rural town and fringe",11759,8267,3553,4714,181,1681,1071,610,1499,1375,124,131
"2011","Uttlesford","E07000077","Rural town and fringe in a sparse setting",0,0,0,0,0,0,0,0,0,0,0,0
"2011","Uttlesford","E07000077","Rural village",8813,6504,3254,3250,53,1032,860,172,1045,833,212,179
"2011","Uttlesford","E07000077","Rural village in a sparse setting",0,0,0,0,0,0,0,0,0,0,0,0
"2011","Uttlesford","E07000077","Rural hamlet and isolated dwellings",4342,3318,1668,1650,23,216,165,51,686,613,73,99
"2011","Uttlesford","E07000077","Rural hamlet and isolated dwellings in a sparse setting",0,0,0,0,0,0,0,0,0,0,0,0
"2011","Broxbourne","E07000095","Total",37658,27460,12262,15198,418,5297,1106,4191,4199,3934,265,284
"2011","Broxbourne","E07000095","Urban (total)",37592,27401,12225,15176,418,5296,1106,4190,4194,3930,264,283
"2011","Broxbourne","E07000095","Urban major conurbation",36504,26434,11778,14656,411,5241,1098,4143,4145,3882,263,273
"2011","Broxbourne","E07000095","Urban minor conurbation",0,0,0,0,0,0,0,0,0,0,0,0
"2011","Broxbourne","E07000095","Urban city and town",1088,967,447,520,7,55,8,47,49,48,1,10
"2011","Broxbourne","E07000095","Urban city and town in a sparse setting",0,0,0,0,0,0,0,0,0,0,0,0
"2011","Broxbourne","E07000095","Rural (total)",66,59,37,22,0,1,0,1,5,4,1,1
"2011","Broxbourne","E07000095","Rural town and fringe",0,0,0,0,0,0,0,0,0,0,0,0
"2011","Broxbourne","E07000095","Rural town and fringe in a sparse setting",0,0,0,0,0,0,0,0,0,0,0,0
"2011","Broxbourne","E07000095","Rural village",66,59,37,22,0,1,0,1,5,4,1,1
"2011","Broxbourne","E07000095","Rural village in a sparse setting",0,0,0,0,0,0,0,0,0,0,0,0
"2011","Broxbourne","E07000095","Rural hamlet and isolated dwellings",0,0,0,0,0,0,0,0,0,0,0,0
"2011","Broxbourne","E07000095","Rural hamlet and isolated dwellings in a sparse setting",0,0,0,0,0,0,0,0,0,0,0,0
"2011","Dacorum","E07000096","Total",59938,38877,17458,21419,373,13045,10407,2638,7107,6516,591,536
"2011","Dacorum","E07000096","Urban (total)",52345,33114,14573,18541,344,12145,9642,2503,6307,5799,508,435
"2011","Dacorum","E07000096","Urban major conurbation",37653,22298,9273,13025,285,10250,8081,2169,4522,4181,341,298
"2011","Dacorum","E07000096","Urban minor conurbation",0,0,0,0,0,0,0,0,0,0,0,0
"2011","Dacorum","E07000096","Urban city and town",14692,10816,5300,5516,59,1895,1561,334,1785,1618,167,137
"2011","Dacorum","E07000096","Urban city and town in a sparse setting",0,0,0,0,0,0,0,0,0,0,0,0
"2011","Dacorum","E07000096","Rural (total)",7593,5763,2885,2878,29,900,765,135,800,717,83,101
"2011","Dacorum","E07000096","Rural town and fringe",3338,2426,1088,1338,14,475,401,74,395,372,23,28
"2011","Dacorum","E07000096","Rural town and fringe in a sparse setting",0,0,0,0,0,0,0,0,0,0,0,0
"2011","Dacorum","E07000096","Rural village",2478,1948,1038,910,12,279,244,35,206,178,28,33
"2011","Dacorum","E07000096","Rural village in a sparse setting",0,0,0,0,0,0,0,0,0,0,0,0
"2011","Dacorum","E07000096","Rural hamlet and isolated dwellings",1777,1389,759,630,3,146,120,26,199,167,32,40
"2011","Dacorum","E07000096","Rural hamlet and isolated dwellings in a sparse setting",0,0,0,0,0,0,0,0,0,0,0,0
"2011","East Hertfordshire","E07000097","Total",56577,40665,18186,22479,508,7185,1129,6056,7446,6906,540,773
"2011","East Hertfordshire","E07000097","Urban (total)",40574,28911,12485,16426,443,5056,766,4290,5759,5391,368,405
"2011","East Hertfordshire","E07000097","Urban major conurbation",1205,880,330,550,19,118,14,104,176,167,9,12
"2011","East Hertfordshire","E07000097","Urban minor conurbation",0,0,0,0,0,0,0,0,0,0,0,0
"2011","East Hertfordshire","E07000097","Urban city and town",39369,28031,12155,15876,424,4938,752,4186,5583,5224,359,393
"2011","East Hertfordshire","E07000097","Urban city and town in a sparse setting",0,0,0,0,0,0,0,0,0,0,0,0
"2011","East Hertfordshire","E07000097","Rural (total)",16003,11754,5701,6053,65,2129,363,1766,1687,1515,172,368
"2011","East Hertfordshire","E07000097","Rural town and fringe",5414,4040,1854,2186,16,716,112,604,554,513,41,88
"2011","East Hertfordshire","E07000097","Rural town and fringe in a sparse setting",0,0,0,0,0,0,0,0,0,0,0,0
"2011","East Hertfordshire","E07000097","Rural village",8326,6103,3006,3097,43,1267,227,1040,742,648,94,171
"2011","East Hertfordshire","E07000097","Rural village in a sparse setting",0,0,0,0,0,0,0,0,0,0,0,0
"2011","East Hertfordshire","E07000097","Rural hamlet and isolated dwellings",2263,1611,841,770,6,146,24,122,391,354,37,109
"2011","East Hertfordshire","E07000097","Rural hamlet and isolated dwellings in a sparse setting",0,0,0,0,0,0,0,0,0,0,0,0
"2011","Hertsmere","E07000098","Total",39778,26897,12489,14408,471,6932,756,6176,4981,4500,481,497
"2011","Hertsmere","E07000098","Urban (total)",34068,22686,10492,12194,416,6292,710,5582,4300,3875,425,374
"2011","Hertsmere","E07000098","Urban major conurbation",24267,15457,6699,8758,343,5017,529,4488,3165,2820,345,285
"2011","Hertsmere","E07000098","Urban minor conurbation",0,0,0,0,0,0,0,0,0,0,0,0
"2011","Hertsmere","E07000098","Urban city and town",9801,7229,3793,3436,73,1275,181,1094,1135,1055,80,89
"2011","Hertsmere","E07000098","Urban city and town in a sparse setting",0,0,0,0,0,0,0,0,0,0,0,0
"2011","Hertsmere","E07000098","Rural (total)",5710,4211,1997,2214,55,640,46,594,681,625,56,123
"2011","Hertsmere","E07000098","Rural town and fringe",4508,3467,1643,1824,50,465,21,444,475,462,13,51
"2011","Hertsmere","E07000098","Rural town and fringe in a sparse setting",0,0,0,0,0,0,0,0,0,0,0,0
"2011","Hertsmere","E07000098","Rural village",686,469,202,267,3,127,6,121,69,56,13,18
"2011","Hertsmere","E07000098","Rural village in a sparse setting",0,0,0,0,0,0,0,0,0,0,0,0
"2011","Hertsmere","E07000098","Rural hamlet and isolated dwellings",516,275,152,123,2,48,19,29,137,107,30,54
"2011","Hertsmere","E07000098","Rural hamlet and isolated dwellings in a sparse setting",0,0,0,0,0,0,0,0,0,0,0,0
"2011","North Hertfordshire","E07000099","Total",53426,35072,16201,18871,472,10304,3774,6530,6993,6460,533,585
"2011","North Hertfordshire","E07000099","Urban (total)",44068,28743,13006,15737,440,8784,3173,5611,5704,5301,403,397
"2011","North Hertfordshire","E07000099","Urban major conurbation",0,0,0,0,0,0,0,0,0,0,0,0
"2011","North Hertfordshire","E07000099","Urban minor conurbation",0,0,0,0,0,0,0,0,0,0,0,0
"2011","North Hertfordshire","E07000099","Urban city and town",44068,28743,13006,15737,440,8784,3173,5611,5704,5301,403,397
"2011","North Hertfordshire","E07000099","Urban city and town in a sparse setting",0,0,0,0,0,0,0,0,0,0,0,0
"2011","North Hertfordshire","E07000099","Rural (total)",9358,6329,3195,3134,32,1520,601,919,1289,1159,130,188
"2011","North Hertfordshire","E07000099","Rural town and fringe",3141,2235,1095,1140,10,507,188,319,359,329,30,30
"2011","North Hertfordshire","E07000099","Rural town and fringe in a sparse setting",0,0,0,0,0,0,0,0,0,0,0,0
"2011","North Hertfordshire","E07000099","Rural village",5057,3333,1699,1634,17,889,354,535,697,631,66,121
"2011","North Hertfordshire","E07000099","Rural village in a sparse setting",0,0,0,0,0,0,0,0,0,0,0,0
"2011","North Hertfordshire","E07000099","Rural hamlet and isolated dwellings",1160,761,401,360,5,124,59,65,233,199,34,37
"2011","North Hertfordshire","E07000099","Rural hamlet and isolated dwellings in a sparse setting",0,0,0,0,0,0,0,0,0,0,0,0
"2011","St Albans","E07000100","Total",56140,40831,19409,21422,261,6832,4753,2079,7624,7065,559,592
"2011","St Albans","E07000100","Urban (total)",50768,36857,17381,19476,235,6017,4080,1937,7149,6643,506,510
"2011","St Albans","E07000100","Urban major conurbation",304,246,145,101,1,3,2,1,52,50,2,2
"2011","St Albans","E07000100","Urban minor conurbation",0,0,0,0,0,0,0,0,0,0,0,0
"2011","St Albans","E07000100","Urban city and town",50464,36611,17236,19375,234,6014,4078,1936,7097,6593,504,508
"2011","St Albans","E07000100","Urban city and town in a sparse setting",0,0,0,0,0,0,0,0,0,0,0,0
"2011","St Albans","E07000100","Rural (total)",5372,3974,2028,1946,26,815,673,142,475,422,53,82
"2011","St Albans","E07000100","Rural town and fringe",3883,2828,1425,1403,23,702,575,127,285,259,26,45
"2011","St Albans","E07000100","Rural town and fringe in a sparse setting",0,0,0,0,0,0,0,0,0,0,0,0
"2011","St Albans","E07000100","Rural village",669,552,278,274,1,75,65,10,31,30,1,10
"2011","St Albans","E07000100","Rural village in a sparse setting",0,0,0,0,0,0,0,0,0,0,0,0
"2011","St Albans","E07000100","Rural hamlet and isolated dwellings",820,594,325,269,2,38,33,5,159,133,26,27
"2011","St Albans","E07000100","Rural hamlet and isolated dwellings in a sparse setting",0,0,0,0,0,0,0,0,0,0,0,0
"2011","Stevenage","E07000101","Total",34898,20339,7736,12603,422,9902,7964,1938,3980,3630,350,255
"2011","Stevenage","E07000101","Urban (total)",34898,20339,7736,12603,422,9902,7964,1938,3980,3630,350,255
"2011","Stevenage","E07000101","Urban major conurbation",0,0,0,0,0,0,0,0,0,0,0,0
"2011","Stevenage","E07000101","Urban minor conurbation",0,0,0,0,0,0,0,0,0,0,0,0
"2011","Stevenage","E07000101","Urban city and town",34898,20339,7736,12603,422,9902,7964,1938,3980,3630,350,255
"2011","Stevenage","E07000101","Urban city and town in a sparse setting",0,0,0,0,0,0,0,0,0,0,0,0
"2011","Stevenage","E07000101","Rural (total)",0,0,0,0,0,0,0,0,0,0,0,0
"2011","Stevenage","E07000101","Rural town and fringe",0,0,0,0,0,0,0,0,0,0,0,0
"2011","Stevenage","E07000101","Rural town and fringe in a sparse setting",0,0,0,0,0,0,0,0,0,0,0,0
"2011","Stevenage","E07000101","Rural village",0,0,0,0,0,0,0,0,0,0,0,0
"2011","Stevenage","E07000101","Rural village in a sparse setting",0,0,0,0,0,0,0,0,0,0,0,0
"2011","Stevenage","E07000101","Rural hamlet and isolated dwellings",0,0,0,0,0,0,0,0,0,0,0,0
"2011","Stevenage","E07000101","Rural hamlet and isolated dwellings in a sparse setting",0,0,0,0,0,0,0,0,0,0,0,0
"2011","Three Rivers","E07000102","Total",35108,25532,11988,13544,194,5318,1680,3638,3708,3253,455,356
"2011","Three Rivers","E07000102","Urban (total)",33180,24179,11323,12856,186,4969,1581,3388,3524,3101,423,322
"2011","Three Rivers","E07000102","Urban major conurbation",29738,21377,9800,11577,178,4722,1533,3189,3181,2807,374,280
"2011","Three Rivers","E07000102","Urban minor conurbation",0,0,0,0,0,0,0,0,0,0,0,0
"2011","Three Rivers","E07000102","Urban city and town",3442,2802,1523,1279,8,247,48,199,343,294,49,42
"2011","Three Rivers","E07000102","Urban city and town in a sparse setting",0,0,0,0,0,0,0,0,0,0,0,0
"2011","Three Rivers","E07000102","Rural (total)",1928,1353,665,688,8,349,99,250,184,152,32,34
"2011","Three Rivers","E07000102","Rural town and fringe",986,589,205,384,4,283,79,204,102,84,18,8
"2011","Three Rivers","E07000102","Rural town and fringe in a sparse setting",0,0,0,0,0,0,0,0,0,0,0,0
"2011","Three Rivers","E07000102","Rural village",622,514,310,204,4,57,19,38,34,28,6,13
"2011","Three Rivers","E07000102","Rural village in a sparse setting",0,0,0,0,0,0,0,0,0,0,0,0
"2011","Three Rivers","E07000102","Rural hamlet and isolated dwellings",320,250,150,100,0,9,1,8,48,40,8,13
"2011","Three Rivers","E07000102","Rural hamlet and isolated dwellings in a sparse setting",0,0,0,0,0,0,0,0,0,0,0,0
"2011","Watford","E07000103","Total",36681,22608,8954,13654,426,5987,1469,4518,7371,6930,441,289
"2011","Watford","E07000103","Urban (total)",36681,22608,8954,13654,426,5987,1469,4518,7371,6930,441,289
"2011","Watford","E07000103","Urban major conurbation",36681,22608,8954,13654,426,5987,1469,4518,7371,6930,441,289
"2011","Watford","E07000103","Urban minor conurbation",0,0,0,0,0,0,0,0,0,0,0,0
"2011","Watford","E07000103","Urban city and town",0,0,0,0,0,0,0,0,0,0,0,0
"2011","Watford","E07000103","Urban city and town in a sparse setting",0,0,0,0,0,0,0,0,0,0,0,0
"2011","Watford","E07000103","Rural (total)",0,0,0,0,0,0,0,0,0,0,0,0
"2011","Watford","E07000103","Rural town and fringe",0,0,0,0,0,0,0,0,0,0,0,0
"2011","Watford","E07000103","Rural town and fringe in a sparse setting",0,0,0,0,0,0,0,0,0,0,0,0
"2011","Watford","E07000103","Rural village",0,0,0,0,0,0,0,0,0,0,0,0
"2011","Watford","E07000103","Rural village in a sparse setting",0,0,0,0,0,0,0,0,0,0,0,0
"2011","Watford","E07000103","Rural hamlet and isolated dwellings",0,0,0,0,0,0,0,0,0,0,0,0
"2011","Watford","E07000103","Rural hamlet and isolated dwellings in a sparse setting",0,0,0,0,0,0,0,0,0,0,0,0
"2011","Welwyn Hatfield","E07000104","Total",43613,24995,11561,13434,395,11741,8693,3048,5911,5532,379,571
"2011","Welwyn Hatfield","E07000104","Urban (total)",38475,20830,9284,11546,369,11462,8524,2938,5356,5054,302,458
"2011","Welwyn Hatfield","E07000104","Urban major conurbation",0,0,0,0,0,0,0,0,0,0,0,0
"2011","Welwyn Hatfield","E07000104","Urban minor conurbation",0,0,0,0,0,0,0,0,0,0,0,0
"2011","Welwyn Hatfield","E07000104","Urban city and town",38475,20830,9284,11546,369,11462,8524,2938,5356,5054,302,458
"2011","Welwyn Hatfield","E07000104","Urban city and town in a sparse setting",0,0,0,0,0,0,0,0,0,0,0,0
"2011","Welwyn Hatfield","E07000104","Rural (total)",5138,4165,2277,1888,26,279,169,110,555,478,77,113
"2011","Welwyn Hatfield","E07000104","Rural town and fringe",2881,2415,1320,1095,23,112,14,98,305,286,19,26
"2011","Welwyn Hatfield","E07000104","Rural town and fringe in a sparse setting",0,0,0,0,0,0,0,0,0,0,0,0
"2011","Welwyn Hatfield","E07000104","Rural village",1064,828,440,388,0,96,89,7,104,78,26,36
"2011","Welwyn Hatfield","E07000104","Rural village in a sparse setting",0,0,0,0,0,0,0,0,0,0,0,0
"2011","Welwyn Hatfield","E07000104","Rural hamlet and isolated dwellings",1193,922,517,405,3,71,66,5,146,114,32,51
"2011","Welwyn Hatfield","E07000104","Rural hamlet and isolated dwellings in a sparse setting",0,0,0,0,0,0,0,0,0,0,0,0
"2011","Breckland","E07000143","Total",54519,37427,20167,17260,310,7511,1287,6224,8294,7306,988,977
"2011","Breckland","E07000143","Urban (total)",23194,14827,6928,7899,159,3896,721,3175,4038,3669,369,274
"2011","Breckland","E07000143","Urban major conurbation",0,0,0,0,0,0,0,0,0,0,0,0
"2011","Breckland","E07000143","Urban minor conurbation",0,0,0,0,0,0,0,0,0,0,0,0
"2011","Breckland","E07000143","Urban city and town",23194,14827,6928,7899,159,3896,721,3175,4038,3669,369,274
"2011","Breckland","E07000143","Urban city and town in a sparse setting",0,0,0,0,0,0,0,0,0,0,0,0
"2011","Breckland","E07000143","Rural (total)",31325,22600,13239,9361,151,3615,566,3049,4256,3637,619,703
"2011","Breckland","E07000143","Rural town and fringe",10735,7576,4632,2944,54,1518,250,1268,1447,1278,169,140
"2011","Breckland","E07000143","Rural town and fringe in a sparse setting",0,0,0,0,0,0,0,0,0,0,0,0
"2011","Breckland","E07000143","Rural village",13167,9636,5497,4139,64,1562,230,1332,1625,1335,290,280
"2011","Breckland","E07000143","Rural village in a sparse setting",352,253,171,82,0,58,10,48,29,20,9,12
"2011","Breckland","E07000143","Rural hamlet and isolated dwellings",6984,5079,2915,2164,32,464,73,391,1140,990,150,269
"2011","Breckland","E07000143","Rural hamlet and isolated dwellings in a sparse setting",87,56,24,32,1,13,3,10,15,14,1,2
"2011","Broadland","E07000144","Total",53336,42343,23080,19263,304,4567,480,4087,5519,4860,659,603
"2011","Broadland","E07000144","Urban (total)",27735,22625,12113,10512,150,2059,193,1866,2661,2360,301,240
"2011","Broadland","E07000144","Urban major conurbation",0,0,0,0,0,0,0,0,0,0,0,0
"2011","Broadland","E07000144","Urban minor conurbation",0,0,0,0,0,0,0,0,0,0,0,0
"2011","Broadland","E07000144","Urban city and town",27735,22625,12113,10512,150,2059,193,1866,2661,2360,301,240
"2011","Broadland","E07000144","Urban city and town in a sparse setting",0,0,0,0,0,0,0,0,0,0,0,0
"2011","Broadland","E07000144","Rural (total)",25601,19718,10967,8751,154,2508,287,2221,2858,2500,358,363
"2011","Broadland","E07000144","Rural town and fringe",13328,10361,5701,4660,69,1336,161,1175,1410,1275,135,152
"2011","Broadland","E07000144","Rural town and fringe in a sparse setting",0,0,0,0,0,0,0,0,0,0,0,0
"2011","Broadland","E07000144","Rural village",8994,6865,3801,3064,79,930,101,829,985,844,141,135
"2011","Broadland","E07000144","Rural village in a sparse setting",0,0,0,0,0,0,0,0,0,0,0,0
"2011","Broadland","E07000144","Rural hamlet and isolated dwellings",3279,2492,1465,1027,6,242,25,217,463,381,82,76
"2011","Broadland","E07000144","Rural hamlet and isolated dwellings in a sparse setting",0,0,0,0,0,0,0,0,0,0,0,0
"2011","Great Yarmouth","E07000145","Total",42079,27073,15024,12049,146,7255,5824,1431,6926,6280,646,679
"2011","Great Yarmouth","E07000145","Urban (total)",27361,15083,7943,7140,94,6289,4971,1318,5459,5016,443,436
"2011","Great Yarmouth","E07000145","Urban major conurbation",0,0,0,0,0,0,0,0,0,0,0,0
"2011","Great Yarmouth","E07000145","Urban minor conurbation",0,0,0,0,0,0,0,0,0,0,0,0
"2011","Great Yarmouth","E07000145","Urban city and town",27361,15083,7943,7140,94,6289,4971,1318,5459,5016,443,436
"2011","Great Yarmouth","E07000145","Urban city and town in a sparse setting",0,0,0,0,0,0,0,0,0,0,0,0
"2011","Great Yarmouth","E07000145","Rural (total)",14718,11990,7081,4909,52,966,853,113,1467,1264,203,243
"2011","Great Yarmouth","E07000145","Rural town and fringe",10581,8611,4976,3635,36,700,606,94,1085,941,144,149
"2011","Great Yarmouth","E07000145","Rural town and fringe in a sparse setting",0,0,0,0,0,0,0,0,0,0,0,0
"2011","Great Yarmouth","E07000145","Rural village",3096,2600,1652,948,7,163,152,11,272,233,39,54
"2011","Great Yarmouth","E07000145","Rural village in a sparse setting",0,0,0,0,0,0,0,0,0,0,0,0
"2011","Great Yarmouth","E07000145","Rural hamlet and isolated dwellings",1041,779,453,326,9,103,95,8,110,90,20,40
"2011","Great Yarmouth","E07000145","Rural hamlet and isolated dwellings in a sparse setting",0,0,0,0,0,0,0,0,0,0,0,0
"2011","King`s Lynn and West Norfolk","E07000146","Total",62977,43707,24908,18799,275,8393,1946,6447,9278,7832,1446,1324
"2011","King`s Lynn and West Norfolk","E07000146","Urban (total)",25665,16493,8616,7877,169,4521,1139,3382,4101,3732,369,381
"2011","King`s Lynn and West Norfolk","E07000146","Urban major conurbation",0,0,0,0,0,0,0,0,0,0,0,0
"2011","King`s Lynn and West Norfolk","E07000146","Urban minor conurbation",0,0,0,0,0,0,0,0,0,0,0,0
"2011","King`s Lynn and West Norfolk","E07000146","Urban city and town",25665,16493,8616,7877,169,4521,1139,3382,4101,3732,369,381
"2011","King`s Lynn and West Norfolk","E07000146","Urban city and town in a sparse setting",0,0,0,0,0,0,0,0,0,0,0,0
"2011","King`s Lynn and West Norfolk","E07000146","Rural (total)",37312,27214,16292,10922,106,3872,807,3065,5177,4100,1077,943
"2011","King`s Lynn and West Norfolk","E07000146","Rural town and fringe",7758,5545,3065,2480,14,793,134,659,1225,778,447,181
"2011","King`s Lynn and West Norfolk","E07000146","Rural town and fringe in a sparse setting",5948,4381,3191,1190,22,628,100,528,804,730,74,113
"2011","King`s Lynn and West Norfolk","E07000146","Rural village",15215,11361,6427,4934,39,1597,370,1227,1890,1537,353,328
"2011","King`s Lynn and West Norfolk","E07000146","Rural village in a sparse setting",2552,1753,1254,499,10,324,69,255,367,320,47,98
"2011","King`s Lynn and West Norfolk","E07000146","Rural hamlet and isolated dwellings",5208,3808,2104,1704,19,413,117,296,771,635,136,197
"2011","King`s Lynn and West Norfolk","E07000146","Rural hamlet and isolated dwellings in a sparse setting",631,366,251,115,2,117,17,100,120,100,20,26
"2011","North Norfolk","E07000147","Total",46046,32293,21083,11210,199,5904,1123,4781,6664,5997,667,986
"2011","North Norfolk","E07000147","Urban (total)",5520,3797,2206,1591,39,893,155,738,722,658,64,69
"2011","North Norfolk","E07000147","Urban major conurbation",0,0,0,0,0,0,0,0,0,0,0,0
"2011","North Norfolk","E07000147","Urban minor conurbation",0,0,0,0,0,0,0,0,0,0,0,0
"2011","North Norfolk","E07000147","Urban city and town",5520,3797,2206,1591,39,893,155,738,722,658,64,69
"2011","North Norfolk","E07000147","Urban city and town in a sparse setting",0,0,0,0,0,0,0,0,0,0,0,0
"2011","North Norfolk","E07000147","Rural (total)",40526,28496,18877,9619,160,5011,968,4043,5942,5339,603,917
"2011","North Norfolk","E07000147","Rural town and fringe",13614,9282,6409,2873,71,1775,309,1466,2250,2050,200,236
"2011","North Norfolk","E07000147","Rural town and fringe in a sparse setting",4945,3286,2139,1147,13,938,190,748,584,522,62,124
"2011","North Norfolk","E07000147","Rural village",12707,9430,6043,3387,46,1383,248,1135,1615,1449,166,233
"2011","North Norfolk","E07000147","Rural village in a sparse setting",3678,2344,1587,757,16,450,110,340,718,636,82,150
"2011","North Norfolk","E07000147","Rural hamlet and isolated dwellings",4594,3487,2258,1229,13,351,79,272,620,550,70,123
"2011","North Norfolk","E07000147","Rural hamlet and isolated dwellings in a sparse setting",988,667,441,226,1,114,32,82,155,132,23,51
"2011","Norwich","E07000148","Total",60319,26442,12463,13979,433,19702,15222,4480,13089,12122,967,653
"2011","Norwich","E07000148","Urban (total)",60319,26442,12463,13979,433,19702,15222,4480,13089,12122,967,653
"2011","Norwich","E07000148","Urban major conurbation",0,0,0,0,0,0,0,0,0,0,0,0
"2011","Norwich","E07000148","Urban minor conurbation",0,0,0,0,0,0,0,0,0,0,0,0
"2011","Norwich","E07000148","Urban city and town",60319,26442,12463,13979,433,19702,15222,4480,13089,12122,967,653
"2011","Norwich","E07000148","Urban city and town in a sparse setting",0,0,0,0,0,0,0,0,0,0,0,0
"2011","Norwich","E07000148","Rural (total)",0,0,0,0,0,0,0,0,0,0,0,0
"2011","Norwich","E07000148","Rural town and fringe",0,0,0,0,0,0,0,0,0,0,0,0
"2011","Norwich","E07000148","Rural town and fringe in a sparse setting",0,0,0,0,0,0,0,0,0,0,0,0
"2011","Norwich","E07000148","Rural village",0,0,0,0,0,0,0,0,0,0,0,0
"2011","Norwich","E07000148","Rural village in a sparse setting",0,0,0,0,0,0,0,0,0,0,0,0
"2011","Norwich","E07000148","Rural hamlet and isolated dwellings",0,0,0,0,0,0,0,0,0,0,0,0
"2011","Norwich","E07000148","Rural hamlet and isolated dwellings in a sparse setting",0,0,0,0,0,0,0,0,0,0,0,0
"2011","South Norfolk","E07000149","Total",52809,39555,21563,17992,537,5965,1440,4525,5916,5278,638,836
"2011","South Norfolk","E07000149","Urban (total)",17581,12494,6699,5795,268,2349,557,1792,2265,2046,219,205
"2011","South Norfolk","E07000149","Urban major conurbation",0,0,0,0,0,0,0,0,0,0,0,0
"2011","South Norfolk","E07000149","Urban minor conurbation",0,0,0,0,0,0,0,0,0,0,0,0
"2011","South Norfolk","E07000149","Urban city and town",17581,12494,6699,5795,268,2349,557,1792,2265,2046,219,205
"2011","South Norfolk","E07000149","Urban city and town in a sparse setting",0,0,0,0,0,0,0,0,0,0,0,0
"2011","South Norfolk","E07000149","Rural (total)",35228,27061,14864,12197,269,3616,883,2733,3651,3232,419,631
"2011","South Norfolk","E07000149","Rural town and fringe",13929,10305,5425,4880,184,1864,413,1451,1399,1235,164,177
"2011","South Norfolk","E07000149","Rural town and fringe in a sparse setting",0,0,0,0,0,0,0,0,0,0,0,0
"2011","South Norfolk","E07000149","Rural village",12229,9720,5405,4315,55,1154,303,851,1114,992,122,186
"2011","South Norfolk","E07000149","Rural village in a sparse setting",0,0,0,0,0,0,0,0,0,0,0,0
"2011","South Norfolk","E07000149","Rural hamlet and isolated dwellings",9070,7036,4034,3002,30,598,167,431,1138,1005,133,268
"2011","South Norfolk","E07000149","Rural hamlet and isolated dwellings in a sparse setting",0,0,0,0,0,0,0,0,0,0,0,0
"2011","Babergh","E07000200","Total",37522,26981,14861,12120,178,4912,3343,1569,4714,4022,692,737
"2011","Babergh","E07000200","Urban (total)",11729,7758,3673,4085,87,2010,1266,744,1736,1547,189,138
"2011","Babergh","E07000200","Urban major conurbation",0,0,0,0,0,0,0,0,0,0,0,0
"2011","Babergh","E07000200","Urban minor conurbation",0,0,0,0,0,0,0,0,0,0,0,0
"2011","Babergh","E07000200","Urban city and town",11729,7758,3673,4085,87,2010,1266,744,1736,1547,189,138
"2011","Babergh","E07000200","Urban city and town in a sparse setting",0,0,0,0,0,0,0,0,0,0,0,0
"2011","Babergh","E07000200","Rural (total)",25793,19223,11188,8035,91,2902,2077,825,2978,2475,503,599
"2011","Babergh","E07000200","Rural town and fringe",11297,8189,4567,3622,37,1536,1091,445,1354,1077,277,181
"2011","Babergh","E07000200","Rural town and fringe in a sparse setting",0,0,0,0,0,0,0,0,0,0,0,0
"2011","Babergh","E07000200","Rural village",9504,7190,4326,2864,35,1040,749,291,971,808,163,268
"2011","Babergh","E07000200","Rural village in a sparse setting",0,0,0,0,0,0,0,0,0,0,0,0
"2011","Babergh","E07000200","Rural hamlet and isolated dwellings",4992,3844,2295,1549,19,326,237,89,653,590,63,150
"2011","Babergh","E07000200","Rural hamlet and isolated dwellings in a sparse setting",0,0,0,0,0,0,0,0,0,0,0,0
"2011","Forest Heath","E07000201","Total",25376,14174,6907,7267,354,3739,1357,2382,6195,5532,663,914
"2011","Forest Heath","E07000201","Urban (total)",14235,7605,3596,4009,226,2506,954,1552,3530,3236,294,368
"2011","Forest Heath","E07000201","Urban major conurbation",0,0,0,0,0,0,0,0,0,0,0,0
"2011","Forest Heath","E07000201","Urban minor conurbation",0,0,0,0,0,0,0,0,0,0,0,0
"2011","Forest Heath","E07000201","Urban city and town",14235,7605,3596,4009,226,2506,954,1552,3530,3236,294,368
"2011","Forest Heath","E07000201","Urban city and town in a sparse setting",0,0,0,0,0,0,0,0,0,0,0,0
"2011","Forest Heath","E07000201","Rural (total)",11141,6569,3311,3258,128,1233,403,830,2665,2296,369,546
"2011","Forest Heath","E07000201","Rural town and fringe",8260,4773,2309,2464,117,966,329,637,2021,1726,295,383
"2011","Forest Heath","E07000201","Rural town and fringe in a sparse setting",0,0,0,0,0,0,0,0,0,0,0,0
"2011","Forest Heath","E07000201","Rural village",2086,1346,752,594,8,192,58,134,418,365,53,122
"2011","Forest Heath","E07000201","Rural village in a sparse setting",0,0,0,0,0,0,0,0,0,0,0,0
"2011","Forest Heath","E07000201","Rural hamlet and isolated dwellings",795,450,250,200,3,75,16,59,226,205,21,41
"2011","Forest Heath","E07000201","Rural hamlet and isolated dwellings in a sparse setting",0,0,0,0,0,0,0,0,0,0,0,0
"2011","Ipswich","E07000202","Total",57298,32467,14723,17744,368,12371,8138,4233,11421,10742,679,671
"2011","Ipswich","E07000202","Urban (total)",57298,32467,14723,17744,368,12371,8138,4233,11421,10742,679,671
"2011","Ipswich","E07000202","Urban major conurbation",0,0,0,0,0,0,0,0,0,0,0,0
"2011","Ipswich","E07000202","Urban minor conurbation",0,0,0,0,0,0,0,0,0,0,0,0
"2011","Ipswich","E07000202","Urban city and town",57298,32467,14723,17744,368,12371,8138,4233,11421,10742,679,671
"2011","Ipswich","E07000202","Urban city and town in a sparse setting",0,0,0,0,0,0,0,0,0,0,0,0
"2011","Ipswich","E07000202","Rural (total)",0,0,0,0,0,0,0,0,0,0,0,0
"2011","Ipswich","E07000202","Rural town and fringe",0,0,0,0,0,0,0,0,0,0,0,0
"2011","Ipswich","E07000202","Rural town and fringe in a sparse setting",0,0,0,0,0,0,0,0,0,0,0,0
"2011","Ipswich","E07000202","Rural village",0,0,0,0,0,0,0,0,0,0,0,0
"2011","Ipswich","E07000202","Rural village in a sparse setting",0,0,0,0,0,0,0,0,0,0,0,0
"2011","Ipswich","E07000202","Rural hamlet and isolated dwellings",0,0,0,0,0,0,0,0,0,0,0,0
"2011","Ipswich","E07000202","Rural hamlet and isolated dwellings in a sparse setting",0,0,0,0,0,0,0,0,0,0,0,0
"2011","Mid Suffolk","E07000203","Total",40306,30262,15876,14386,343,4544,3280,1264,4515,3804,711,642
"2011","Mid Suffolk","E07000203","Urban (total)",10269,7378,3505,3873,96,1427,1024,403,1247,1130,117,121
"2011","Mid Suffolk","E07000203","Urban major conurbation",0,0,0,0,0,0,0,0,0,0,0,0
"2011","Mid Suffolk","E07000203","Urban minor conurbation",0,0,0,0,0,0,0,0,0,0,0,0
"2011","Mid Suffolk","E07000203","Urban city and town",10269,7378,3505,3873,96,1427,1024,403,1247,1130,117,121
"2011","Mid Suffolk","E07000203","Urban city and town in a sparse setting",0,0,0,0,0,0,0,0,0,0,0,0
"2011","Mid Suffolk","E07000203","Rural (total)",30037,22884,12371,10513,247,3117,2256,861,3268,2674,594,521
"2011","Mid Suffolk","E07000203","Rural town and fringe",9765,7314,3807,3507,88,1270,861,409,964,854,110,129
"2011","Mid Suffolk","E07000203","Rural town and fringe in a sparse setting",0,0,0,0,0,0,0,0,0,0,0,0
"2011","Mid Suffolk","E07000203","Rural village",12818,9689,5243,4446,113,1392,1049,343,1409,1073,336,215
"2011","Mid Suffolk","E07000203","Rural village in a sparse setting",0,0,0,0,0,0,0,0,0,0,0,0
"2011","Mid Suffolk","E07000203","Rural hamlet and isolated dwellings",7454,5881,3321,2560,46,455,346,109,895,747,148,177
"2011","Mid Suffolk","E07000203","Rural hamlet and isolated dwellings in a sparse setting",0,0,0,0,0,0,0,0,0,0,0,0
"2011","St Edmundsbury","E07000204","Total",45802,30626,15437,15189,376,7321,2808,4513,6798,5892,906,681
"2011","St Edmundsbury","E07000204","Urban (total)",29531,18782,8723,10059,309,5544,2161,3383,4612,4243,369,284
"2011","St Edmundsbury","E07000204","Urban major conurbation",0,0,0,0,0,0,0,0,0,0,0,0
"2011","St Edmundsbury","E07000204","Urban minor conurbation",0,0,0,0,0,0,0,0,0,0,0,0
"2011","St Edmundsbury","E07000204","Urban city and town",29531,18782,8723,10059,309,5544,2161,3383,4612,4243,369,284
"2011","St Edmundsbury","E07000204","Urban city and town in a sparse setting",0,0,0,0,0,0,0,0,0,0,0,0
"2011","St Edmundsbury","E07000204","Rural (total)",16271,11844,6714,5130,67,1777,647,1130,2186,1649,537,397
"2011","St Edmundsbury","E07000204","Rural town and fringe",3838,2853,1537,1316,15,486,154,332,423,321,102,61
"2011","St Edmundsbury","E07000204","Rural town and fringe in a sparse setting",0,0,0,0,0,0,0,0,0,0,0,0
"2011","St Edmundsbury","E07000204","Rural village",9276,6668,3853,2815,44,1028,401,627,1336,963,373,200
"2011","St Edmundsbury","E07000204","Rural village in a sparse setting",0,0,0,0,0,0,0,0,0,0,0,0
"2011","St Edmundsbury","E07000204","Rural hamlet and isolated dwellings",3157,2323,1324,999,8,263,92,171,427,365,62,136
"2011","St Edmundsbury","E07000204","Rural hamlet and isolated dwellings in a sparse setting",0,0,0,0,0,0,0,0,0,0,0,0
"2011","Suffolk Coastal","E07000205","Total",53558,39193,22774,16419,234,6066,521,5545,7267,6487,780,798
"2011","Suffolk Coastal","E07000205","Urban (total)",29364,21907,12088,9819,81,3104,282,2822,3981,3683,298,291
"2011","Suffolk Coastal","E07000205","Urban major conurbation",0,0,0,0,0,0,0,0,0,0,0,0
"2011","Suffolk Coastal","E07000205","Urban minor conurbation",0,0,0,0,0,0,0,0,0,0,0,0
"2011","Suffolk Coastal","E07000205","Urban city and town",29364,21907,12088,9819,81,3104,282,2822,3981,3683,298,291
"2011","Suffolk Coastal","E07000205","Urban city and town in a sparse setting",0,0,0,0,0,0,0,0,0,0,0,0
"2011","Suffolk Coastal","E07000205","Rural (total)",24194,17286,10686,6600,153,2962,239,2723,3286,2804,482,507
"2011","Suffolk Coastal","E07000205","Rural town and fringe",5340,3656,1956,1700,39,857,65,792,699,634,65,89
"2011","Suffolk Coastal","E07000205","Rural town and fringe in a sparse setting",3441,2227,1414,813,7,643,69,574,504,450,54,60
"2011","Suffolk Coastal","E07000205","Rural village",9069,6721,4195,2526,82,954,70,884,1140,912,228,172
"2011","Suffolk Coastal","E07000205","Rural village in a sparse setting",129,91,77,14,2,21,1,20,12,10,2,3
"2011","Suffolk Coastal","E07000205","Rural hamlet and isolated dwellings",5679,4186,2736,1450,22,432,32,400,870,745,125,169
"2011","Suffolk Coastal","E07000205","Rural hamlet and isolated dwellings in a sparse setting",536,405,308,97,1,55,2,53,61,53,8,14
"2011","Waveney","E07000206","Total",50883,35290,20503,14787,215,7148,4234,2914,7578,6920,658,652
"2011","Waveney","E07000206","Urban (total)",37306,25466,14235,11231,141,5410,2957,2453,5885,5417,468,404
"2011","Waveney","E07000206","Urban major conurbation",0,0,0,0,0,0,0,0,0,0,0,0
"2011","Waveney","E07000206","Urban minor conurbation",0,0,0,0,0,0,0,0,0,0,0,0
"2011","Waveney","E07000206","Urban city and town",37306,25466,14235,11231,141,5410,2957,2453,5885,5417,468,404
"2011","Waveney","E07000206","Urban city and town in a sparse setting",0,0,0,0,0,0,0,0,0,0,0,0
"2011","Waveney","E07000206","Rural (total)",13577,9824,6268,3556,74,1738,1277,461,1693,1503,190,248
"2011","Waveney","E07000206","Rural town and fringe",8334,5907,3856,2051,57,1234,866,368,998,880,118,138
"2011","Waveney","E07000206","Rural town and fringe in a sparse setting",0,0,0,0,0,0,0,0,0,0,0,0
"2011","Waveney","E07000206","Rural village",2718,2052,1263,789,12,314,263,51,296,260,36,44
"2011","Waveney","E07000206","Rural village in a sparse setting",0,0,0,0,0,0,0,0,0,0,0,0
"2011","Waveney","E07000206","Rural hamlet and isolated dwellings",2525,1865,1149,716,5,190,148,42,399,363,36,66
"2011","Waveney","E07000206","Rural hamlet and isolated dwellings in a sparse setting",0,0,0,0,0,0,0,0,0,0,0,0
"2011","Camden","E09000007","Total",97534,31368,16644,14724,674,32295,22473,9822,31434,29706,1728,1763
"2011","Camden","E09000007","Urban (total)",97534,31368,16644,14724,674,32295,22473,9822,31434,29706,1728,1763
"2011","Camden","E09000007","Urban major conurbation",97534,31368,16644,14724,674,32295,22473,9822,31434,29706,1728,1763
"2011","Camden","E09000007","Urban minor conurbation",0,0,0,0,0,0,0,0,0,0,0,0
"2011","Camden","E09000007","Urban city and town",0,0,0,0,0,0,0,0,0,0,0,0
"2011","Camden","E09000007","Urban city and town in a sparse setting",0,0,0,0,0,0,0,0,0,0,0,0
"2011","Camden","E09000007","Rural (total)",0,0,0,0,0,0,0,0,0,0,0,0
"2011","Camden","E09000007","Rural town and fringe",0,0,0,0,0,0,0,0,0,0,0,0
"2011","Camden","E09000007","Rural town and fringe in a sparse setting",0,0,0,0,0,0,0,0,0,0,0,0
"2011","Camden","E09000007","Rural village",0,0,0,0,0,0,0,0,0,0,0,0
"2011","Camden","E09000007","Rural village in a sparse setting",0,0,0,0,0,0,0,0,0,0,0,0
"2011","Camden","E09000007","Rural hamlet and isolated dwellings",0,0,0,0,0,0,0,0,0,0,0,0
"2011","Camden","E09000007","Rural hamlet and isolated dwellings in a sparse setting",0,0,0,0,0,0,0,0,0,0,0,0
"2011","City of London","E09000001","Total",4385,1855,1093,762,13,725,458,267,1573,1451,122,219
"2011","City of London","E09000001","Urban (total)",4385,1855,1093,762,13,725,458,267,1573,1451,122,219
"2011","City of London","E09000001","Urban major conurbation",4385,1855,1093,762,13,725,458,267,1573,1451,122,219
"2011","City of London","E09000001","Urban minor conurbation",0,0,0,0,0,0,0,0,0,0,0,0
"2011","City of London","E09000001","Urban city and town",0,0,0,0,0,0,0,0,0,0,0,0
"2011","City of London","E09000001","Urban city and town in a sparse setting",0,0,0,0,0,0,0,0,0,0,0,0
"2011","City of London","E09000001","Rural (total)",0,0,0,0,0,0,0,0,0,0,0,0
"2011","City of London","E09000001","Rural town and fringe",0,0,0,0,0,0,0,0,0,0,0,0
"2011","City of London","E09000001","Rural town and fringe in a sparse setting",0,0,0,0,0,0,0,0,0,0,0,0
"2011","City of London","E09000001","Rural village",0,0,0,0,0,0,0,0,0,0,0,0
"2011","City of London","E09000001","Rural village in a sparse setting",0,0,0,0,0,0,0,0,0,0,0,0
"2011","City of London","E09000001","Rural hamlet and isolated dwellings",0,0,0,0,0,0,0,0,0,0,0,0
"2011","City of London","E09000001","Rural hamlet and isolated dwellings in a sparse setting",0,0,0,0,0,0,0,0,0,0,0,0
"2011","Hackney","E09000012","Total",101690,24179,8597,15582,2374,44430,24163,20267,29449,28112,1337,1258
"2011","Hackney","E09000012","Urban (total)",101431,24130,8586,15544,2369,44310,24150,20160,29367,28036,1331,1255
"2011","Hackney","E09000012","Urban major conurbation",101431,24130,8586,15544,2369,44310,24150,20160,29367,28036,1331,1255
"2011","Hackney","E09000012","Urban minor conurbation",0,0,0,0,0,0,0,0,0,0,0,0
"2011","Hackney","E09000012","Urban city and town",0,0,0,0,0,0,0,0,0,0,0,0
"2011","Hackney","E09000012","Urban city and town in a sparse setting",0,0,0,0,0,0,0,0,0,0,0,0
"2011","Hackney","E09000012","Rural (total)",259,49,11,38,5,120,13,107,82,76,6,3
"2011","Hackney","E09000012","Rural town and fringe",259,49,11,38,5,120,13,107,82,76,6,3
"2011","Hackney","E09000012","Rural town and fringe in a sparse setting",0,0,0,0,0,0,0,0,0,0,0,0
"2011","Hackney","E09000012","Rural village",0,0,0,0,0,0,0,0,0,0,0,0
"2011","Hackney","E09000012","Rural village in a sparse setting",0,0,0,0,0,0,0,0,0,0,0,0
"2011","Hackney","E09000012","Rural hamlet and isolated dwellings",0,0,0,0,0,0,0,0,0,0,0,0
"2011","Hackney","E09000012","Rural hamlet and isolated dwellings in a sparse setting",0,0,0,0,0,0,0,0,0,0,0,0
"2011","Hammersmith and Fulham","E09000013","Total",80590,27397,12777,14620,1257,25133,12683,12450,25555,24215,1340,1248
"2011","Hammersmith and Fulham","E09000013","Urban (total)",80590,27397,12777,14620,1257,25133,12683,12450,25555,24215,1340,1248
"2011","Hammersmith and Fulham","E09000013","Urban major conurbation",80590,27397,12777,14620,1257,25133,12683,12450,25555,24215,1340,1248
"2011","Hammersmith and Fulham","E09000013","Urban minor conurbation",0,0,0,0,0,0,0,0,0,0,0,0
"2011","Hammersmith and Fulham","E09000013","Urban city and town",0,0,0,0,0,0,0,0,0,0,0,0
"2011","Hammersmith and Fulham","E09000013","Urban city and town in a sparse setting",0,0,0,0,0,0,0,0,0,0,0,0
"2011","Hammersmith and Fulham","E09000013","Rural (total)",0,0,0,0,0,0,0,0,0,0,0,0
"2011","Hammersmith and Fulham","E09000013","Rural town and fringe",0,0,0,0,0,0,0,0,0,0,0,0
"2011","Hammersmith and Fulham","E09000013","Rural town and fringe in a sparse setting",0,0,0,0,0,0,0,0,0,0,0,0
"2011","Hammersmith and Fulham","E09000013","Rural village",0,0,0,0,0,0,0,0,0,0,0,0
"2011","Hammersmith and Fulham","E09000013","Rural village in a sparse setting",0,0,0,0,0,0,0,0,0,0,0,0
"2011","Hammersmith and Fulham","E09000013","Rural hamlet and isolated dwellings",0,0,0,0,0,0,0,0,0,0,0,0
"2011","Hammersmith and Fulham","E09000013","Rural hamlet and isolated dwellings in a sparse setting",0,0,0,0,0,0,0,0,0,0,0,0
"2011","Haringey","E09000014","Total",101955,39603,16326,23277,1533,27242,17288,9954,32095,30924,1171,1482
"2011","Haringey","E09000014","Urban (total)",101955,39603,16326,23277,1533,27242,17288,9954,32095,30924,1171,1482
"2011","Haringey","E09000014","Urban major conurbation",101955,39603,16326,23277,1533,27242,17288,9954,32095,30924,1171,1482
"2011","Haringey","E09000014","Urban minor conurbation",0,0,0,0,0,0,0,0,0,0,0,0
"2011","Haringey","E09000014","Urban city and town",0,0,0,0,0,0,0,0,0,0,0,0
"2011","Haringey","E09000014","Urban city and town in a sparse setting",0,0,0,0,0,0,0,0,0,0,0,0
"2011","Haringey","E09000014","Rural (total)",0,0,0,0,0,0,0,0,0,0,0,0
"2011","Haringey","E09000014","Rural town and fringe",0,0,0,0,0,0,0,0,0,0,0,0
"2011","Haringey","E09000014","Rural town and fringe in a sparse setting",0,0,0,0,0,0,0,0,0,0,0,0
"2011","Haringey","E09000014","Rural village",0,0,0,0,0,0,0,0,0,0,0,0
"2011","Haringey","E09000014","Rural village in a sparse setting",0,0,0,0,0,0,0,0,0,0,0,0
"2011","Haringey","E09000014","Rural hamlet and isolated dwellings",0,0,0,0,0,0,0,0,0,0,0,0
"2011","Haringey","E09000014","Rural hamlet and isolated dwellings in a sparse setting",0,0,0,0,0,0,0,0,0,0,0,0
"2011","Islington","E09000019","Total",93556,26564,10587,15977,1207,39342,25014,14328,25217,23954,1263,1226
"2011","Islington","E09000019","Urban (total)",93556,26564,10587,15977,1207,39342,25014,14328,25217,23954,1263,1226
"2011","Islington","E09000019","Urban major conurbation",93556,26564,10587,15977,1207,39342,25014,14328,25217,23954,1263,1226
"2011","Islington","E09000019","Urban minor conurbation",0,0,0,0,0,0,0,0,0,0,0,0
"2011","Islington","E09000019","Urban city and town",0,0,0,0,0,0,0,0,0,0,0,0
"2011","Islington","E09000019","Urban city and town in a sparse setting",0,0,0,0,0,0,0,0,0,0,0,0
"2011","Islington","E09000019","Rural (total)",0,0,0,0,0,0,0,0,0,0,0,0
"2011","Islington","E09000019","Rural town and fringe",0,0,0,0,0,0,0,0,0,0,0,0
"2011","Islington","E09000019","Rural town and fringe in a sparse setting",0,0,0,0,0,0,0,0,0,0,0,0
"2011","Islington","E09000019","Rural village",0,0,0,0,0,0,0,0,0,0,0,0
"2011","Islington","E09000019","Rural village in a sparse setting",0,0,0,0,0,0,0,0,0,0,0,0
"2011","Islington","E09000019","Rural hamlet and isolated dwellings",0,0,0,0,0,0,0,0,0,0,0,0
"2011","Islington","E09000019","Rural hamlet and isolated dwellings in a sparse setting",0,0,0,0,0,0,0,0,0,0,0,0
"2011","Kensington and Chelsea","E09000020","Total",78536,28007,17933,10074,700,19271,7201,12070,28108,26676,1432,2450
"2011","Kensington and Chelsea","E09000020","Urban (total)",78536,28007,17933,10074,700,19271,7201,12070,28108,26676,1432,2450
"2011","Kensington and Chelsea","E09000020","Urban major conurbation",78536,28007,17933,10074,700,19271,7201,12070,28108,26676,1432,2450
"2011","Kensington and Chelsea","E09000020","Urban minor conurbation",0,0,0,0,0,0,0,0,0,0,0,0
"2011","Kensington and Chelsea","E09000020","Urban city and town",0,0,0,0,0,0,0,0,0,0,0,0
"2011","Kensington and Chelsea","E09000020","Urban city and town in a sparse setting",0,0,0,0,0,0,0,0,0,0,0,0
"2011","Kensington and Chelsea","E09000020","Rural (total)",0,0,0,0,0,0,0,0,0,0,0,0
"2011","Kensington and Chelsea","E09000020","Rural town and fringe",0,0,0,0,0,0,0,0,0,0,0,0
"2011","Kensington and Chelsea","E09000020","Rural town and fringe in a sparse setting",0,0,0,0,0,0,0,0,0,0,0,0
"2011","Kensington and Chelsea","E09000020","Rural village",0,0,0,0,0,0,0,0,0,0,0,0
"2011","Kensington and Chelsea","E09000020","Rural village in a sparse setting",0,0,0,0,0,0,0,0,0,0,0,0
"2011","Kensington and Chelsea","E09000020","Rural hamlet and isolated dwellings",0,0,0,0,0,0,0,0,0,0,0,0
"2011","Kensington and Chelsea","E09000020","Rural hamlet and isolated dwellings in a sparse setting",0,0,0,0,0,0,0,0,0,0,0,0
"2011","Lambeth","E09000022","Total",130017,42885,14778,28107,1987,45619,25496,20123,38133,36023,2110,1393
"2011","Lambeth","E09000022","Urban (total)",130017,42885,14778,28107,1987,45619,25496,20123,38133,36023,2110,1393
"2011","Lambeth","E09000022","Urban major conurbation",130017,42885,14778,28107,1987,45619,25496,20123,38133,36023,2110,1393
"2011","Lambeth","E09000022","Urban minor conurbation",0,0,0,0,0,0,0,0,0,0,0,0
"2011","Lambeth","E09000022","Urban city and town",0,0,0,0,0,0,0,0,0,0,0,0
"2011","Lambeth","E09000022","Urban city and town in a sparse setting",0,0,0,0,0,0,0,0,0,0,0,0
"2011","Lambeth","E09000022","Rural (total)",0,0,0,0,0,0,0,0,0,0,0,0
"2011","Lambeth","E09000022","Rural town and fringe",0,0,0,0,0,0,0,0,0,0,0,0
"2011","Lambeth","E09000022","Rural town and fringe in a sparse setting",0,0,0,0,0,0,0,0,0,0,0,0
"2011","Lambeth","E09000022","Rural village",0,0,0,0,0,0,0,0,0,0,0,0
"2011","Lambeth","E09000022","Rural village in a sparse setting",0,0,0,0,0,0,0,0,0,0,0,0
"2011","Lambeth","E09000022","Rural hamlet and isolated dwellings",0,0,0,0,0,0,0,0,0,0,0,0
"2011","Lambeth","E09000022","Rural hamlet and isolated dwellings in a sparse setting",0,0,0,0,0,0,0,0,0,0,0,0
"2011","Lewisham","E09000023","Total",116091,49228,17273,31955,1436,36052,18084,17968,28216,26665,1551,1159
"2011","Lewisham","E09000023","Urban (total)",116091,49228,17273,31955,1436,36052,18084,17968,28216,26665,1551,1159
"2011","Lewisham","E09000023","Urban major conurbation",116091,49228,17273,31955,1436,36052,18084,17968,28216,26665,1551,1159
"2011","Lewisham","E09000023","Urban minor conurbation",0,0,0,0,0,0,0,0,0,0,0,0
"2011","Lewisham","E09000023","Urban city and town",0,0,0,0,0,0,0,0,0,0,0,0
"2011","Lewisham","E09000023","Urban city and town in a sparse setting",0,0,0,0,0,0,0,0,0,0,0,0
"2011","Lewisham","E09000023","Rural (total)",0,0,0,0,0,0,0,0,0,0,0,0
"2011","Lewisham","E09000023","Rural town and fringe",0,0,0,0,0,0,0,0,0,0,0,0
"2011","Lewisham","E09000023","Rural town and fringe in a sparse setting",0,0,0,0,0,0,0,0,0,0,0,0
"2011","Lewisham","E09000023","Rural village",0,0,0,0,0,0,0,0,0,0,0,0
"2011","Lewisham","E09000023","Rural village in a sparse setting",0,0,0,0,0,0,0,0,0,0,0,0
"2011","Lewisham","E09000023","Rural hamlet and isolated dwellings",0,0,0,0,0,0,0,0,0,0,0,0
"2011","Lewisham","E09000023","Rural hamlet and isolated dwellings in a sparse setting",0,0,0,0,0,0,0,0,0,0,0,0
"2011","Newham","E09000025","Total",101519,33822,12993,20829,1806,30092,18592,11500,34570,33118,1452,1229
"2011","Newham","E09000025","Urban (total)",101519,33822,12993,20829,1806,30092,18592,11500,34570,33118,1452,1229
"2011","Newham","E09000025","Urban major conurbation",101519,33822,12993,20829,1806,30092,18592,11500,34570,33118,1452,1229
"2011","Newham","E09000025","Urban minor conurbation",0,0,0,0,0,0,0,0,0,0,0,0
"2011","Newham","E09000025","Urban city and town",0,0,0,0,0,0,0,0,0,0,0,0
"2011","Newham","E09000025","Urban city and town in a sparse setting",0,0,0,0,0,0,0,0,0,0,0,0
"2011","Newham","E09000025","Rural (total)",0,0,0,0,0,0,0,0,0,0,0,0
"2011","Newham","E09000025","Rural town and fringe",0,0,0,0,0,0,0,0,0,0,0,0
"2011","Newham","E09000025","Rural town and fringe in a sparse setting",0,0,0,0,0,0,0,0,0,0,0,0
"2011","Newham","E09000025","Rural village",0,0,0,0,0,0,0,0,0,0,0,0
"2011","Newham","E09000025","Rural village in a sparse setting",0,0,0,0,0,0,0,0,0,0,0,0
"2011","Newham","E09000025","Rural hamlet and isolated dwellings",0,0,0,0,0,0,0,0,0,0,0,0
"2011","Newham","E09000025","Rural hamlet and isolated dwellings in a sparse setting",0,0,0,0,0,0,0,0,0,0,0,0
"2011","Southwark","E09000028","Total",120422,35330,11805,23525,2453,52644,37628,15016,28493,26752,1741,1502
"2011","Southwark","E09000028","Urban (total)",120422,35330,11805,23525,2453,52644,37628,15016,28493,26752,1741,1502
"2011","Southwark","E09000028","Urban major conurbation",120422,35330,11805,23525,2453,52644,37628,15016,28493,26752,1741,1502
"2011","Southwark","E09000028","Urban minor conurbation",0,0,0,0,0,0,0,0,0,0,0,0
"2011","Southwark","E09000028","Urban city and town",0,0,0,0,0,0,0,0,0,0,0,0
"2011","Southwark","E09000028","Urban city and town in a sparse setting",0,0,0,0,0,0,0,0,0,0,0,0
"2011","Southwark","E09000028","Rural (total)",0,0,0,0,0,0,0,0,0,0,0,0
"2011","Southwark","E09000028","Rural town and fringe",0,0,0,0,0,0,0,0,0,0,0,0
"2011","Southwark","E09000028","Rural town and fringe in a sparse setting",0,0,0,0,0,0,0,0,0,0,0,0
"2011","Southwark","E09000028","Rural village",0,0,0,0,0,0,0,0,0,0,0,0
"2011","Southwark","E09000028","Rural village in a sparse setting",0,0,0,0,0,0,0,0,0,0,0,0
"2011","Southwark","E09000028","Rural hamlet and isolated dwellings",0,0,0,0,0,0,0,0,0,0,0,0
"2011","Southwark","E09000028","Rural hamlet and isolated dwellings in a sparse setting",0,0,0,0,0,0,0,0,0,0,0,0
"2011","Tower Hamlets","E09000030","Total",101257,24552,8648,15904,2383,40106,17548,22558,32964,31227,1737,1252
"2011","Tower Hamlets","E09000030","Urban (total)",101257,24552,8648,15904,2383,40106,17548,22558,32964,31227,1737,1252
"2011","Tower Hamlets","E09000030","Urban major conurbation",101257,24552,8648,15904,2383,40106,17548,22558,32964,31227,1737,1252
"2011","Tower Hamlets","E09000030","Urban minor conurbation",0,0,0,0,0,0,0,0,0,0,0,0
"2011","Tower Hamlets","E09000030","Urban city and town",0,0,0,0,0,0,0,0,0,0,0,0
"2011","Tower Hamlets","E09000030","Urban city and town in a sparse setting",0,0,0,0,0,0,0,0,0,0,0,0
"2011","Tower Hamlets","E09000030","Rural (total)",0,0,0,0,0,0,0,0,0,0,0,0
"2011","Tower Hamlets","E09000030","Rural town and fringe",0,0,0,0,0,0,0,0,0,0,0,0
"2011","Tower Hamlets","E09000030","Rural town and fringe in a sparse setting",0,0,0,0,0,0,0,0,0,0,0,0
"2011","Tower Hamlets","E09000030","Rural village",0,0,0,0,0,0,0,0,0,0,0,0
"2011","Tower Hamlets","E09000030","Rural village in a sparse setting",0,0,0,0,0,0,0,0,0,0,0,0
"2011","Tower Hamlets","E09000030","Rural hamlet and isolated dwellings",0,0,0,0,0,0,0,0,0,0,0,0
"2011","Tower Hamlets","E09000030","Rural hamlet and isolated dwellings in a sparse setting",0,0,0,0,0,0,0,0,0,0,0,0
"2011","Wandsworth","E09000032","Total",130493,59393,24067,35326,1911,26516,16752,9764,41317,39171,2146,1356
"2011","Wandsworth","E09000032","Urban (total)",130493,59393,24067,35326,1911,26516,16752,9764,41317,39171,2146,1356
"2011","Wandsworth","E09000032","Urban major conurbation",130493,59393,24067,35326,1911,26516,16752,9764,41317,39171,2146,1356
"2011","Wandsworth","E09000032","Urban minor conurbation",0,0,0,0,0,0,0,0,0,0,0,0
"2011","Wandsworth","E09000032","Urban city and town",0,0,0,0,0,0,0,0,0,0,0,0
"2011","Wandsworth","E09000032","Urban city and town in a sparse setting",0,0,0,0,0,0,0,0,0,0,0,0
"2011","Wandsworth","E09000032","Rural (total)",0,0,0,0,0,0,0,0,0,0,0,0
"2011","Wandsworth","E09000032","Rural town and fringe",0,0,0,0,0,0,0,0,0,0,0,0
"2011","Wandsworth","E09000032","Rural town and fringe in a sparse setting",0,0,0,0,0,0,0,0,0,0,0,0
"2011","Wandsworth","E09000032","Rural village",0,0,0,0,0,0,0,0,0,0,0,0
"2011","Wandsworth","E09000032","Rural village in a sparse setting",0,0,0,0,0,0,0,0,0,0,0,0
"2011","Wandsworth","E09000032","Rural hamlet and isolated dwellings",0,0,0,0,0,0,0,0,0,0,0,0
"2011","Wandsworth","E09000032","Rural hamlet and isolated dwellings in a sparse setting",0,0,0,0,0,0,0,0,0,0,0,0
"2011","Westminster","E09000033","Total",105772,32287,18692,13595,885,27348,12543,14805,41949,39732,2217,3303
"2011","Westminster","E09000033","Urban (total)",105772,32287,18692,13595,885,27348,12543,14805,41949,39732,2217,3303
"2011","Westminster","E09000033","Urban major conurbation",105772,32287,18692,13595,885,27348,12543,14805,41949,39732,2217,3303
"2011","Westminster","E09000033","Urban minor conurbation",0,0,0,0,0,0,0,0,0,0,0,0
"2011","Westminster","E09000033","Urban city and town",0,0,0,0,0,0,0,0,0,0,0,0
"2011","Westminster","E09000033","Urban city and town in a sparse setting",0,0,0,0,0,0,0,0,0,0,0,0
"2011","Westminster","E09000033","Rural (total)",0,0,0,0,0,0,0,0,0,0,0,0
"2011","Westminster","E09000033","Rural town and fringe",0,0,0,0,0,0,0,0,0,0,0,0
"2011","Westminster","E09000033","Rural town and fringe in a sparse setting",0,0,0,0,0,0,0,0,0,0,0,0
"2011","Westminster","E09000033","Rural village",0,0,0,0,0,0,0,0,0,0,0,0
"2011","Westminster","E09000033","Rural village in a sparse setting",0,0,0,0,0,0,0,0,0,0,0,0
"2011","Westminster","E09000033","Rural hamlet and isolated dwellings",0,0,0,0,0,0,0,0,0,0,0,0
"2011","Westminster","E09000033","Rural hamlet and isolated dwellings in a sparse setting",0,0,0,0,0,0,0,0,0,0,0,0
"2011","Barking and Dagenham","E09000002","Total",69681,32324,11908,20416,906,23459,19782,3677,12328,11559,769,664
"2011","Barking and Dagenham","E09000002","Urban (total)",69681,32324,11908,20416,906,23459,19782,3677,12328,11559,769,664
"2011","Barking and Dagenham","E09000002","Urban major conurbation",69681,32324,11908,20416,906,23459,19782,3677,12328,11559,769,664
"2011","Barking and Dagenham","E09000002","Urban minor conurbation",0,0,0,0,0,0,0,0,0,0,0,0
"2011","Barking and Dagenham","E09000002","Urban city and town",0,0,0,0,0,0,0,0,0,0,0,0
"2011","Barking and Dagenham","E09000002","Urban city and town in a sparse setting",0,0,0,0,0,0,0,0,0,0,0,0
"2011","Barking and Dagenham","E09000002","Rural (total)",0,0,0,0,0,0,0,0,0,0,0,0
"2011","Barking and Dagenham","E09000002","Rural town and fringe",0,0,0,0,0,0,0,0,0,0,0,0
"2011","Barking and Dagenham","E09000002","Rural town and fringe in a sparse setting",0,0,0,0,0,0,0,0,0,0,0,0
"2011","Barking and Dagenham","E09000002","Rural village",0,0,0,0,0,0,0,0,0,0,0,0
"2011","Barking and Dagenham","E09000002","Rural village in a sparse setting",0,0,0,0,0,0,0,0,0,0,0,0
"2011","Barking and Dagenham","E09000002","Rural hamlet and isolated dwellings",0,0,0,0,0,0,0,0,0,0,0,0
"2011","Barking and Dagenham","E09000002","Rural hamlet and isolated dwellings in a sparse setting",0,0,0,0,0,0,0,0,0,0,0,0
"2011","Barnet","E09000003","Total",135916,78350,38105,40245,1191,19334,11664,7670,34854,33175,1679,2187
"2011","Barnet","E09000003","Urban (total)",135916,78350,38105,40245,1191,19334,11664,7670,34854,33175,1679,2187
"2011","Barnet","E09000003","Urban major conurbation",135654,78129,37986,40143,1191,19331,11661,7670,34821,33146,1675,2182
"2011","Barnet","E09000003","Urban minor conurbation",0,0,0,0,0,0,0,0,0,0,0,0
"2011","Barnet","E09000003","Urban city and town",262,221,119,102,0,3,3,0,33,29,4,5
"2011","Barnet","E09000003","Urban city and town in a sparse setting",0,0,0,0,0,0,0,0,0,0,0,0
"2011","Barnet","E09000003","Rural (total)",0,0,0,0,0,0,0,0,0,0,0,0
"2011","Barnet","E09000003","Rural town and fringe",0,0,0,0,0,0,0,0,0,0,0,0
"2011","Barnet","E09000003","Rural town and fringe in a sparse setting",0,0,0,0,0,0,0,0,0,0,0,0
"2011","Barnet","E09000003","Rural village",0,0,0,0,0,0,0,0,0,0,0,0
"2011","Barnet","E09000003","Rural village in a sparse setting",0,0,0,0,0,0,0,0,0,0,0,0
"2011","Barnet","E09000003","Rural hamlet and isolated dwellings",0,0,0,0,0,0,0,0,0,0,0,0
"2011","Barnet","E09000003","Rural hamlet and isolated dwellings in a sparse setting",0,0,0,0,0,0,0,0,0,0,0,0
"2011","Bexley","E09000004","Total",92604,67154,30127,37027,754,13377,1693,11684,10556,9721,835,763
"2011","Bexley","E09000004","Urban (total)",92544,67104,30099,37005,754,13377,1693,11684,10548,9716,832,761
"2011","Bexley","E09000004","Urban major conurbation",92544,67104,30099,37005,754,13377,1693,11684,10548,9716,832,761
"2011","Bexley","E09000004","Urban minor conurbation",0,0,0,0,0,0,0,0,0,0,0,0
"2011","Bexley","E09000004","Urban city and town",0,0,0,0,0,0,0,0,0,0,0,0
"2011","Bexley","E09000004","Urban city and town in a sparse setting",0,0,0,0,0,0,0,0,0,0,0,0
"2011","Bexley","E09000004","Rural (total)",60,50,28,22,0,0,0,0,8,5,3,2
"2011","Bexley","E09000004","Rural town and fringe",0,0,0,0,0,0,0,0,0,0,0,0
"2011","Bexley","E09000004","Rural town and fringe in a sparse setting",0,0,0,0,0,0,0,0,0,0,0,0
"2011","Bexley","E09000004","Rural village",0,0,0,0,0,0,0,0,0,0,0,0
"2011","Bexley","E09000004","Rural village in a sparse setting",0,0,0,0,0,0,0,0,0,0,0,0
"2011","Bexley","E09000004","Rural hamlet and isolated dwellings",60,50,28,22,0,0,0,0,8,5,3,2
"2011","Bexley","E09000004","Rural hamlet and isolated dwellings in a sparse setting",0,0,0,0,0,0,0,0,0,0,0,0
"2011","Brent","E09000005","Total",110286,47324,22416,24908,1636,26591,10686,15905,33181,31784,1397,1554
"2011","Brent","E09000005","Urban (total)",110286,47324,22416,24908,1636,26591,10686,15905,33181,31784,1397,1554
"2011","Brent","E09000005","Urban major conurbation",110286,47324,22416,24908,1636,26591,10686,15905,33181,31784,1397,1554
"2011","Brent","E09000005","Urban minor conurbation",0,0,0,0,0,0,0,0,0,0,0,0
"2011","Brent","E09000005","Urban city and town",0,0,0,0,0,0,0,0,0,0,0,0
"2011","Brent","E09000005","Urban city and town in a sparse setting",0,0,0,0,0,0,0,0,0,0,0,0
"2011","Brent","E09000005","Rural (total)",0,0,0,0,0,0,0,0,0,0,0,0
"2011","Brent","E09000005","Rural town and fringe",0,0,0,0,0,0,0,0,0,0,0,0
"2011","Brent","E09000005","Rural town and fringe in a sparse setting",0,0,0,0,0,0,0,0,0,0,0,0
"2011","Brent","E09000005","Rural village",0,0,0,0,0,0,0,0,0,0,0,0
"2011","Brent","E09000005","Rural village in a sparse setting",0,0,0,0,0,0,0,0,0,0,0,0
"2011","Brent","E09000005","Rural hamlet and isolated dwellings",0,0,0,0,0,0,0,0,0,0,0,0
"2011","Brent","E09000005","Rural hamlet and isolated dwellings in a sparse setting",0,0,0,0,0,0,0,0,0,0,0,0
"2011","Bromley","E09000006","Total",130862,92785,43649,49136,1036,18425,1987,16438,17393,16229,1164,1223
"2011","Bromley","E09000006","Urban (total)",129376,91544,42936,48608,1030,18343,1978,16365,17260,16124,1136,1199
"2011","Bromley","E09000006","Urban major conurbation",123772,86702,40645,46057,983,18097,1958,16139,16846,15775,1071,1144
"2011","Bromley","E09000006","Urban minor conurbation",0,0,0,0,0,0,0,0,0,0,0,0
"2011","Bromley","E09000006","Urban city and town",5604,4842,2291,2551,47,246,20,226,414,349,65,55
"2011","Bromley","E09000006","Urban city and town in a sparse setting",0,0,0,0,0,0,0,0,0,0,0,0
"2011","Bromley","E09000006","Rural (total)",1486,1241,713,528,6,82,9,73,133,105,28,24
"2011","Bromley","E09000006","Rural town and fringe",253,208,113,95,0,16,3,13,26,20,6,3
"2011","Bromley","E09000006","Rural town and fringe in a sparse setting",0,0,0,0,0,0,0,0,0,0,0,0
"2011","Bromley","E09000006","Rural village",751,608,350,258,6,53,3,50,73,56,17,11
"2011","Bromley","E09000006","Rural village in a sparse setting",0,0,0,0,0,0,0,0,0,0,0,0
"2011","Bromley","E09000006","Rural hamlet and isolated dwellings",482,425,250,175,0,13,3,10,34,29,5,10
"2011","Bromley","E09000006","Rural hamlet and isolated dwellings in a sparse setting",0,0,0,0,0,0,0,0,0,0,0,0
"2011","Croydon","E09000008","Total",145010,85230,34882,50348,1855,25887,14362,11525,30472,28762,1710,1566
"2011","Croydon","E09000008","Urban (total)",145010,85230,34882,50348,1855,25887,14362,11525,30472,28762,1710,1566
"2011","Croydon","E09000008","Urban major conurbation",145010,85230,34882,50348,1855,25887,14362,11525,30472,28762,1710,1566
"2011","Croydon","E09000008","Urban minor conurbation",0,0,0,0,0,0,0,0,0,0,0,0
"2011","Croydon","E09000008","Urban city and town",0,0,0,0,0,0,0,0,0,0,0,0
"2011","Croydon","E09000008","Urban city and town in a sparse setting",0,0,0,0,0,0,0,0,0,0,0,0
"2011","Croydon","E09000008","Rural (total)",0,0,0,0,0,0,0,0,0,0,0,0
"2011","Croydon","E09000008","Rural town and fringe",0,0,0,0,0,0,0,0,0,0,0,0
"2011","Croydon","E09000008","Rural town and fringe in a sparse setting",0,0,0,0,0,0,0,0,0,0,0,0
"2011","Croydon","E09000008","Rural village",0,0,0,0,0,0,0,0,0,0,0,0
"2011","Croydon","E09000008","Rural village in a sparse setting",0,0,0,0,0,0,0,0,0,0,0,0
"2011","Croydon","E09000008","Rural hamlet and isolated dwellings",0,0,0,0,0,0,0,0,0,0,0,0
"2011","Croydon","E09000008","Rural hamlet and isolated dwellings in a sparse setting",0,0,0,0,0,0,0,0,0,0,0,0
"2011","Ealing","E09000009","Total",124082,63420,28414,35006,2174,22472,13007,9465,34182,32696,1486,1834
"2011","Ealing","E09000009","Urban (total)",124082,63420,28414,35006,2174,22472,13007,9465,34182,32696,1486,1834
"2011","Ealing","E09000009","Urban major conurbation",124082,63420,28414,35006,2174,22472,13007,9465,34182,32696,1486,1834
"2011","Ealing","E09000009","Urban minor conurbation",0,0,0,0,0,0,0,0,0,0,0,0
"2011","Ealing","E09000009","Urban city and town",0,0,0,0,0,0,0,0,0,0,0,0
"2011","Ealing","E09000009","Urban city and town in a sparse setting",0,0,0,0,0,0,0,0,0,0,0,0
"2011","Ealing","E09000009","Rural (total)",0,0,0,0,0,0,0,0,0,0,0,0
"2011","Ealing","E09000009","Rural town and fringe",0,0,0,0,0,0,0,0,0,0,0,0
"2011","Ealing","E09000009","Rural town and fringe in a sparse setting",0,0,0,0,0,0,0,0,0,0,0,0
"2011","Ealing","E09000009","Rural village",0,0,0,0,0,0,0,0,0,0,0,0
"2011","Ealing","E09000009","Rural village in a sparse setting",0,0,0,0,0,0,0,0,0,0,0,0
"2011","Ealing","E09000009","Rural hamlet and isolated dwellings",0,0,0,0,0,0,0,0,0,0,0,0
"2011","Ealing","E09000009","Rural hamlet and isolated dwellings in a sparse setting",0,0,0,0,0,0,0,0,0,0,0,0
"2011","Enfield","E09000010","Total",119916,69462,31452,38010,1087,21073,13666,7407,26591,25395,1196,1703
"2011","Enfield","E09000010","Urban (total)",119440,69092,31239,37853,1085,21046,13641,7405,26530,25347,1183,1687
"2011","Enfield","E09000010","Urban major conurbation",118832,68537,30948,37589,1084,21040,13636,7404,26492,25309,1183,1679
"2011","Enfield","E09000010","Urban minor conurbation",0,0,0,0,0,0,0,0,0,0,0,0
"2011","Enfield","E09000010","Urban city and town",608,555,291,264,1,6,5,1,38,38,0,8
"2011","Enfield","E09000010","Urban city and town in a sparse setting",0,0,0,0,0,0,0,0,0,0,0,0
"2011","Enfield","E09000010","Rural (total)",476,370,213,157,2,27,25,2,61,48,13,16
"2011","Enfield","E09000010","Rural town and fringe",0,0,0,0,0,0,0,0,0,0,0,0
"2011","Enfield","E09000010","Rural town and fringe in a sparse setting",0,0,0,0,0,0,0,0,0,0,0,0
"2011","Enfield","E09000010","Rural village",320,261,162,99,1,17,15,2,33,26,7,8
"2011","Enfield","E09000010","Rural village in a sparse setting",0,0,0,0,0,0,0,0,0,0,0,0
"2011","Enfield","E09000010","Rural hamlet and isolated dwellings",156,109,51,58,1,10,10,0,28,22,6,8
"2011","Enfield","E09000010","Rural hamlet and isolated dwellings in a sparse setting",0,0,0,0,0,0,0,0,0,0,0,0
"2011","Greenwich","E09000011","Total",101045,43719,16585,27134,1580,34662,22878,11784,20004,18678,1326,1080
"2011","Greenwich","E09000011","Urban (total)",101045,43719,16585,27134,1580,34662,22878,11784,20004,18678,1326,1080
"2011","Greenwich","E09000011","Urban major conurbation",101045,43719,16585,27134,1580,34662,22878,11784,20004,18678,1326,1080
"2011","Greenwich","E09000011","Urban minor conurbation",0,0,0,0,0,0,0,0,0,0,0,0
"2011","Greenwich","E09000011","Urban city and town",0,0,0,0,0,0,0,0,0,0,0,0
"2011","Greenwich","E09000011","Urban city and town in a sparse setting",0,0,0,0,0,0,0,0,0,0,0,0
"2011","Greenwich","E09000011","Rural (total)",0,0,0,0,0,0,0,0,0,0,0,0
"2011","Greenwich","E09000011","Rural town and fringe",0,0,0,0,0,0,0,0,0,0,0,0
"2011","Greenwich","E09000011","Rural town and fringe in a sparse setting",0,0,0,0,0,0,0,0,0,0,0,0
"2011","Greenwich","E09000011","Rural village",0,0,0,0,0,0,0,0,0,0,0,0
"2011","Greenwich","E09000011","Rural village in a sparse setting",0,0,0,0,0,0,0,0,0,0,0,0
"2011","Greenwich","E09000011","Rural hamlet and isolated dwellings",0,0,0,0,0,0,0,0,0,0,0,0
"2011","Greenwich","E09000011","Rural hamlet and isolated dwellings in a sparse setting",0,0,0,0,0,0,0,0,0,0,0,0
"2011","Harrow","E09000015","Total",84268,55001,26246,28755,821,8923,5157,3766,18324,17165,1159,1199
"2011","Harrow","E09000015","Urban (total)",84027,54868,26191,28677,782,8894,5154,3740,18289,17131,1158,1194
"2011","Harrow","E09000015","Urban major conurbation",84027,54868,26191,28677,782,8894,5154,3740,18289,17131,1158,1194
"2011","Harrow","E09000015","Urban minor conurbation",0,0,0,0,0,0,0,0,0,0,0,0
"2011","Harrow","E09000015","Urban city and town",0,0,0,0,0,0,0,0,0,0,0,0
"2011","Harrow","E09000015","Urban city and town in a sparse setting",0,0,0,0,0,0,0,0,0,0,0,0
"2011","Harrow","E09000015","Rural (total)",241,133,55,78,39,29,3,26,35,34,1,5
"2011","Harrow","E09000015","Rural town and fringe",0,0,0,0,0,0,0,0,0,0,0,0
"2011","Harrow","E09000015","Rural town and fringe in a sparse setting",0,0,0,0,0,0,0,0,0,0,0,0
"2011","Harrow","E09000015","Rural village",241,133,55,78,39,29,3,26,35,34,1,5
"2011","Harrow","E09000015","Rural village in a sparse setting",0,0,0,0,0,0,0,0,0,0,0,0
"2011","Harrow","E09000015","Rural hamlet and isolated dwellings",0,0,0,0,0,0,0,0,0,0,0,0
"2011","Harrow","E09000015","Rural hamlet and isolated dwellings in a sparse setting",0,0,0,0,0,0,0,0,0,0,0,0
"2011","Havering","E09000016","Total",97199,71698,34625,37073,586,13799,10464,3335,10337,9601,736,779
"2011","Havering","E09000016","Urban (total)",96438,71063,34231,36832,586,13769,10440,3329,10253,9529,724,767
"2011","Havering","E09000016","Urban major conurbation",96186,70864,34137,36727,586,13747,10421,3326,10230,9512,718,759
"2011","Havering","E09000016","Urban minor conurbation",0,0,0,0,0,0,0,0,0,0,0,0
"2011","Havering","E09000016","Urban city and town",252,199,94,105,0,22,19,3,23,17,6,8
"2011","Havering","E09000016","Urban city and town in a sparse setting",0,0,0,0,0,0,0,0,0,0,0,0
"2011","Havering","E09000016","Rural (total)",761,635,394,241,0,30,24,6,84,72,12,12
"2011","Havering","E09000016","Rural town and fringe",246,224,157,67,0,8,8,0,11,9,2,3
"2011","Havering","E09000016","Rural town and fringe in a sparse setting",0,0,0,0,0,0,0,0,0,0,0,0
"2011","Havering","E09000016","Rural village",116,81,45,36,0,7,7,0,27,24,3,1
"2011","Havering","E09000016","Rural village in a sparse setting",0,0,0,0,0,0,0,0,0,0,0,0
"2011","Havering","E09000016","Rural hamlet and isolated dwellings",399,330,192,138,0,15,9,6,46,39,7,8
"2011","Havering","E09000016","Rural hamlet and isolated dwellings in a sparse setting",0,0,0,0,0,0,0,0,0,0,0,0
"2011","Hillingdon","E09000017","Total",100214,63011,27921,35090,1280,16752,10481,6271,18141,16691,1450,1030
"2011","Hillingdon","E09000017","Urban (total)",97206,61078,27066,34012,1268,16029,9880,6149,17834,16422,1412,997
"2011","Hillingdon","E09000017","Urban major conurbation",96098,60533,26839,33694,1261,15853,9802,6051,17476,16083,1393,975
"2011","Hillingdon","E09000017","Urban minor conurbation",0,0,0,0,0,0,0,0,0,0,0,0
"2011","Hillingdon","E09000017","Urban city and town",1108,545,227,318,7,176,78,98,358,339,19,22
"2011","Hillingdon","E09000017","Urban city and town in a sparse setting",0,0,0,0,0,0,0,0,0,0,0,0
"2011","Hillingdon","E09000017","Rural (total)",3008,1933,855,1078,12,723,601,122,307,269,38,33
"2011","Hillingdon","E09000017","Rural town and fringe",2639,1639,730,909,9,692,577,115,273,240,33,26
"2011","Hillingdon","E09000017","Rural town and fringe in a sparse setting",0,0,0,0,0,0,0,0,0,0,0,0
"2011","Hillingdon","E09000017","Rural village",318,263,106,157,3,26,19,7,23,21,2,3
"2011","Hillingdon","E09000017","Rural village in a sparse setting",0,0,0,0,0,0,0,0,0,0,0,0
"2011","Hillingdon","E09000017","Rural hamlet and isolated dwellings",51,31,19,12,0,5,5,0,11,8,3,4
"2011","Hillingdon","E09000017","Rural hamlet and isolated dwellings in a sparse setting",0,0,0,0,0,0,0,0,0,0,0,0
"2011","Hounslow","E09000018","Total",94902,47562,20048,27514,2245,21682,14296,7386,22206,21099,1107,1207
"2011","Hounslow","E09000018","Urban (total)",94902,47562,20048,27514,2245,21682,14296,7386,22206,21099,1107,1207
"2011","Hounslow","E09000018","Urban major conurbation",94902,47562,20048,27514,2245,21682,14296,7386,22206,21099,1107,1207
"2011","Hounslow","E09000018","Urban minor conurbation",0,0,0,0,0,0,0,0,0,0,0,0
"2011","Hounslow","E09000018","Urban city and town",0,0,0,0,0,0,0,0,0,0,0,0
"2011","Hounslow","E09000018","Urban city and town in a sparse setting",0,0,0,0,0,0,0,0,0,0,0,0
"2011","Hounslow","E09000018","Rural (total)",0,0,0,0,0,0,0,0,0,0,0,0
"2011","Hounslow","E09000018","Rural town and fringe",0,0,0,0,0,0,0,0,0,0,0,0
"2011","Hounslow","E09000018","Rural town and fringe in a sparse setting",0,0,0,0,0,0,0,0,0,0,0,0
"2011","Hounslow","E09000018","Rural village",0,0,0,0,0,0,0,0,0,0,0,0
"2011","Hounslow","E09000018","Rural village in a sparse setting",0,0,0,0,0,0,0,0,0,0,0,0
"2011","Hounslow","E09000018","Rural hamlet and isolated dwellings",0,0,0,0,0,0,0,0,0,0,0,0
"2011","Hounslow","E09000018","Rural hamlet and isolated dwellings in a sparse setting",0,0,0,0,0,0,0,0,0,0,0,0
"2011","Kingston upon Thames","E09000021","Total",63639,40762,17727,23035,434,7502,5252,2250,14312,13391,921,629
"2011","Kingston upon Thames","E09000021","Urban (total)",63477,40636,17676,22960,433,7494,5246,2248,14285,13368,917,629
"2011","Kingston upon Thames","E09000021","Urban major conurbation",62646,40037,17402,22635,429,7440,5199,2241,14125,13216,909,615
"2011","Kingston upon Thames","E09000021","Urban minor conurbation",0,0,0,0,0,0,0,0,0,0,0,0
"2011","Kingston upon Thames","E09000021","Urban city and town",831,599,274,325,4,54,47,7,160,152,8,14
"2011","Kingston upon Thames","E09000021","Urban city and town in a sparse setting",0,0,0,0,0,0,0,0,0,0,0,0
"2011","Kingston upon Thames","E09000021","Rural (total)",162,126,51,75,1,8,6,2,27,23,4,0
"2011","Kingston upon Thames","E09000021","Rural town and fringe",0,0,0,0,0,0,0,0,0,0,0,0
"2011","Kingston upon Thames","E09000021","Rural town and fringe in a sparse setting",0,0,0,0,0,0,0,0,0,0,0,0
"2011","Kingston upon Thames","E09000021","Rural village",162,126,51,75,1,8,6,2,27,23,4,0
"2011","Kingston upon Thames","E09000021","Rural village in a sparse setting",0,0,0,0,0,0,0,0,0,0,0,0
"2011","Kingston upon Thames","E09000021","Rural hamlet and isolated dwellings",0,0,0,0,0,0,0,0,0,0,0,0
"2011","Kingston upon Thames","E09000021","Rural hamlet and isolated dwellings in a sparse setting",0,0,0,0,0,0,0,0,0,0,0,0
"2011","Merton","E09000024","Total",78757,46689,20160,26529,671,11102,2887,8215,19503,18478,1025,792
"2011","Merton","E09000024","Urban (total)",78757,46689,20160,26529,671,11102,2887,8215,19503,18478,1025,792
"2011","Merton","E09000024","Urban major conurbation",78757,46689,20160,26529,671,11102,2887,8215,19503,18478,1025,792
"2011","Merton","E09000024","Urban minor conurbation",0,0,0,0,0,0,0,0,0,0,0,0
"2011","Merton","E09000024","Urban city and town",0,0,0,0,0,0,0,0,0,0,0,0
"2011","Merton","E09000024","Urban city and town in a sparse setting",0,0,0,0,0,0,0,0,0,0,0,0
"2011","Merton","E09000024","Rural (total)",0,0,0,0,0,0,0,0,0,0,0,0
"2011","Merton","E09000024","Rural town and fringe",0,0,0,0,0,0,0,0,0,0,0,0
"2011","Merton","E09000024","Rural town and fringe in a sparse setting",0,0,0,0,0,0,0,0,0,0,0,0
"2011","Merton","E09000024","Rural village",0,0,0,0,0,0,0,0,0,0,0,0
"2011","Merton","E09000024","Rural village in a sparse setting",0,0,0,0,0,0,0,0,0,0,0,0
"2011","Merton","E09000024","Rural hamlet and isolated dwellings",0,0,0,0,0,0,0,0,0,0,0,0
"2011","Merton","E09000024","Rural hamlet and isolated dwellings in a sparse setting",0,0,0,0,0,0,0,0,0,0,0,0
"2011","Redbridge","E09000026","Total",99105,62983,27911,35072,1003,11289,6269,5020,22657,21441,1216,1173
"2011","Redbridge","E09000026","Urban (total)",99105,62983,27911,35072,1003,11289,6269,5020,22657,21441,1216,1173
"2011","Redbridge","E09000026","Urban major conurbation",99105,62983,27911,35072,1003,11289,6269,5020,22657,21441,1216,1173
"2011","Redbridge","E09000026","Urban minor conurbation",0,0,0,0,0,0,0,0,0,0,0,0
"2011","Redbridge","E09000026","Urban city and town",0,0,0,0,0,0,0,0,0,0,0,0
"2011","Redbridge","E09000026","Urban city and town in a sparse setting",0,0,0,0,0,0,0,0,0,0,0,0
"2011","Redbridge","E09000026","Rural (total)",0,0,0,0,0,0,0,0,0,0,0,0
"2011","Redbridge","E09000026","Rural town and fringe",0,0,0,0,0,0,0,0,0,0,0,0
"2011","Redbridge","E09000026","Rural town and fringe in a sparse setting",0,0,0,0,0,0,0,0,0,0,0,0
"2011","Redbridge","E09000026","Rural village",0,0,0,0,0,0,0,0,0,0,0,0
"2011","Redbridge","E09000026","Rural village in a sparse setting",0,0,0,0,0,0,0,0,0,0,0,0
"2011","Redbridge","E09000026","Rural hamlet and isolated dwellings",0,0,0,0,0,0,0,0,0,0,0,0
"2011","Redbridge","E09000026","Rural hamlet and isolated dwellings in a sparse setting",0,0,0,0,0,0,0,0,0,0,0,0
"2011","Richmond upon Thames","E09000027","Total",79835,50750,23756,26994,601,10051,2451,7600,17440,16410,1030,993
"2011","Richmond upon Thames","E09000027","Urban (total)",79835,50750,23756,26994,601,10051,2451,7600,17440,16410,1030,993
"2011","Richmond upon Thames","E09000027","Urban major conurbation",79835,50750,23756,26994,601,10051,2451,7600,17440,16410,1030,993
"2011","Richmond upon Thames","E09000027","Urban minor conurbation",0,0,0,0,0,0,0,0,0,0,0,0
"2011","Richmond upon Thames","E09000027","Urban city and town",0,0,0,0,0,0,0,0,0,0,0,0
"2011","Richmond upon Thames","E09000027","Urban city and town in a sparse setting",0,0,0,0,0,0,0,0,0,0,0,0
"2011","Richmond upon Thames","E09000027","Rural (total)",0,0,0,0,0,0,0,0,0,0,0,0
"2011","Richmond upon Thames","E09000027","Rural town and fringe",0,0,0,0,0,0,0,0,0,0,0,0
"2011","Richmond upon Thames","E09000027","Rural town and fringe in a sparse setting",0,0,0,0,0,0,0,0,0,0,0,0
"2011","Richmond upon Thames","E09000027","Rural village",0,0,0,0,0,0,0,0,0,0,0,0
"2011","Richmond upon Thames","E09000027","Rural village in a sparse setting",0,0,0,0,0,0,0,0,0,0,0,0
"2011","Richmond upon Thames","E09000027","Rural hamlet and isolated dwellings",0,0,0,0,0,0,0,0,0,0,0,0
"2011","Richmond upon Thames","E09000027","Rural hamlet and isolated dwellings in a sparse setting",0,0,0,0,0,0,0,0,0,0,0,0
"2011","Sutton","E09000029","Total",78174,53152,22357,30795,611,11422,6421,5001,12429,11671,758,560
"2011","Sutton","E09000029","Urban (total)",78174,53152,22357,30795,611,11422,6421,5001,12429,11671,758,560
"2011","Sutton","E09000029","Urban major conurbation",78048,53063,22310,30753,611,11403,6403,5000,12413,11662,751,558
"2011","Sutton","E09000029","Urban minor conurbation",0,0,0,0,0,0,0,0,0,0,0,0
"2011","Sutton","E09000029","Urban city and town",126,89,47,42,0,19,18,1,16,9,7,2
"2011","Sutton","E09000029","Urban city and town in a sparse setting",0,0,0,0,0,0,0,0,0,0,0,0
"2011","Sutton","E09000029","Rural (total)",0,0,0,0,0,0,0,0,0,0,0,0
"2011","Sutton","E09000029","Rural town and fringe",0,0,0,0,0,0,0,0,0,0,0,0
"2011","Sutton","E09000029","Rural town and fringe in a sparse setting",0,0,0,0,0,0,0,0,0,0,0,0
"2011","Sutton","E09000029","Rural village",0,0,0,0,0,0,0,0,0,0,0,0
"2011","Sutton","E09000029","Rural village in a sparse setting",0,0,0,0,0,0,0,0,0,0,0,0
"2011","Sutton","E09000029","Rural hamlet and isolated dwellings",0,0,0,0,0,0,0,0,0,0,0,0
"2011","Sutton","E09000029","Rural hamlet and isolated dwellings in a sparse setting",0,0,0,0,0,0,0,0,0,0,0,0
"2011","Waltham Forest","E09000031","Total",96861,48361,19396,28965,1018,21376,10401,10975,25102,23919,1183,1004
"2011","Waltham Forest","E09000031","Urban (total)",96861,48361,19396,28965,1018,21376,10401,10975,25102,23919,1183,1004
"2011","Waltham Forest","E09000031","Urban major conurbation",96861,48361,19396,28965,1018,21376,10401,10975,25102,23919,1183,1004
"2011","Waltham Forest","E09000031","Urban minor conurbation",0,0,0,0,0,0,0,0,0,0,0,0
"2011","Waltham Forest","E09000031","Urban city and town",0,0,0,0,0,0,0,0,0,0,0,0
"2011","Waltham Forest","E09000031","Urban city and town in a sparse setting",0,0,0,0,0,0,0,0,0,0,0,0
"2011","Waltham Forest","E09000031","Rural (total)",0,0,0,0,0,0,0,0,0,0,0,0
"2011","Waltham Forest","E09000031","Rural town and fringe",0,0,0,0,0,0,0,0,0,0,0,0
"2011","Waltham Forest","E09000031","Rural town and fringe in a sparse setting",0,0,0,0,0,0,0,0,0,0,0,0
"2011","Waltham Forest","E09000031","Rural village",0,0,0,0,0,0,0,0,0,0,0,0
"2011","Waltham Forest","E09000031","Rural village in a sparse setting",0,0,0,0,0,0,0,0,0,0,0,0
"2011","Waltham Forest","E09000031","Rural hamlet and isolated dwellings",0,0,0,0,0,0,0,0,0,0,0,0
"2011","Waltham Forest","E09000031","Rural hamlet and isolated dwellings in a sparse setting",0,0,0,0,0,0,0,0,0,0,0,0
"2011","Bracknell Forest","E06000036","Total",45878,31419,11420,19999,527,7678,2600,5078,5734,4874,860,520
"2011","Bracknell Forest","E06000036","Urban (total)",44854,30609,10942,19667,518,7644,2585,5059,5591,4743,848,492
"2011","Bracknell Forest","E06000036","Urban major conurbation",0,0,0,0,0,0,0,0,0,0,0,0
"2011","Bracknell Forest","E06000036","Urban minor conurbation",0,0,0,0,0,0,0,0,0,0,0,0
"2011","Bracknell Forest","E06000036","Urban city and town",44854,30609,10942,19667,518,7644,2585,5059,5591,4743,848,492
"2011","Bracknell Forest","E06000036","Urban city and town in a sparse setting",0,0,0,0,0,0,0,0,0,0,0,0
"2011","Bracknell Forest","E06000036","Rural (total)",1024,810,478,332,9,34,15,19,143,131,12,28
"2011","Bracknell Forest","E06000036","Rural town and fringe",46,34,20,14,1,3,2,1,7,6,1,1
"2011","Bracknell Forest","E06000036","Rural town and fringe in a sparse setting",0,0,0,0,0,0,0,0,0,0,0,0
"2011","Bracknell Forest","E06000036","Rural village",529,448,306,142,7,18,9,9,49,46,3,7
"2011","Bracknell Forest","E06000036","Rural village in a sparse setting",0,0,0,0,0,0,0,0,0,0,0,0
"2011","Bracknell Forest","E06000036","Rural hamlet and isolated dwellings",449,328,152,176,1,13,4,9,87,79,8,20
"2011","Bracknell Forest","E06000036","Rural hamlet and isolated dwellings in a sparse setting",0,0,0,0,0,0,0,0,0,0,0,0
"2011","Brighton and Hove","E06000043","Total",121540,64790,28397,36393,1045,18187,11928,6259,35959,34081,1878,1559
"2011","Brighton and Hove","E06000043","Urban (total)",121183,64582,28290,36292,1044,18099,11868,6231,35905,34034,1871,1553
"2011","Brighton and Hove","E06000043","Urban major conurbation",0,0,0,0,0,0,0,0,0,0,0,0
"2011","Brighton and Hove","E06000043","Urban minor conurbation",0,0,0,0,0,0,0,0,0,0,0,0
"2011","Brighton and Hove","E06000043","Urban city and town",121183,64582,28290,36292,1044,18099,11868,6231,35905,34034,1871,1553
"2011","Brighton and Hove","E06000043","Urban city and town in a sparse setting",0,0,0,0,0,0,0,0,0,0,0,0
"2011","Brighton and Hove","E06000043","Rural (total)",357,208,107,101,1,88,60,28,54,47,7,6
"2011","Brighton and Hove","E06000043","Rural town and fringe",141,100,50,50,1,22,13,9,16,12,4,2
"2011","Brighton and Hove","E06000043","Rural town and fringe in a sparse setting",0,0,0,0,0,0,0,0,0,0,0,0
"2011","Brighton and Hove","E06000043","Rural village",0,0,0,0,0,0,0,0,0,0,0,0
"2011","Brighton and Hove","E06000043","Rural village in a sparse setting",0,0,0,0,0,0,0,0,0,0,0,0
"2011","Brighton and Hove","E06000043","Rural hamlet and isolated dwellings",216,108,57,51,0,66,47,19,38,35,3,4
"2011","Brighton and Hove","E06000043","Rural hamlet and isolated dwellings in a sparse setting",0,0,0,0,0,0,0,0,0,0,0,0
"2011","Isle of Wight","E06000046","Total",61085,42817,25091,17726,362,6523,598,5925,10639,9663,976,744
"2011","Isle of Wight","E06000046","Urban (total)",40769,27312,14886,12426,231,4681,482,4199,8097,7428,669,448
"2011","Isle of Wight","E06000046","Urban major conurbation",0,0,0,0,0,0,0,0,0,0,0,0
"2011","Isle of Wight","E06000046","Urban minor conurbation",0,0,0,0,0,0,0,0,0,0,0,0
"2011","Isle of Wight","E06000046","Urban city and town",40769,27312,14886,12426,231,4681,482,4199,8097,7428,669,448
"2011","Isle of Wight","E06000046","Urban city and town in a sparse setting",0,0,0,0,0,0,0,0,0,0,0,0
"2011","Isle of Wight","E06000046","Rural (total)",20316,15505,10205,5300,131,1842,116,1726,2542,2235,307,296
"2011","Isle of Wight","E06000046","Rural town and fringe",12356,8965,5886,3079,112,1373,82,1291,1740,1550,190,166
"2011","Isle of Wight","E06000046","Rural town and fringe in a sparse setting",0,0,0,0,0,0,0,0,0,0,0,0
"2011","Isle of Wight","E06000046","Rural village",4606,3763,2547,1216,9,355,25,330,416,356,60,63
"2011","Isle of Wight","E06000046","Rural village in a sparse setting",0,0,0,0,0,0,0,0,0,0,0,0
"2011","Isle of Wight","E06000046","Rural hamlet and isolated dwellings",3354,2777,1772,1005,10,114,9,105,386,329,57,67
"2011","Isle of Wight","E06000046","Rural hamlet and isolated dwellings in a sparse setting",0,0,0,0,0,0,0,0,0,0,0,0
"2011","Medway","E06000035","Total",106209,71853,30697,41156,1114,13996,4155,9841,18153,16627,1526,1093
"2011","Medway","E06000035","Urban (total)",94677,62747,26514,36233,935,12878,4036,8842,17143,15745,1398,974
"2011","Medway","E06000035","Urban major conurbation",0,0,0,0,0,0,0,0,0,0,0,0
"2011","Medway","E06000035","Urban minor conurbation",0,0,0,0,0,0,0,0,0,0,0,0
"2011","Medway","E06000035","Urban city and town",94677,62747,26514,36233,935,12878,4036,8842,17143,15745,1398,974
"2011","Medway","E06000035","Urban city and town in a sparse setting",0,0,0,0,0,0,0,0,0,0,0,0
"2011","Medway","E06000035","Rural (total)",11532,9106,4183,4923,179,1118,119,999,1010,882,128,119
"2011","Medway","E06000035","Rural town and fringe",8487,6899,3270,3629,134,739,87,652,630,553,77,85
"2011","Medway","E06000035","Rural town and fringe in a sparse setting",0,0,0,0,0,0,0,0,0,0,0,0
"2011","Medway","E06000035","Rural village",1906,1251,477,774,41,341,24,317,261,228,33,12
"2011","Medway","E06000035","Rural village in a sparse setting",0,0,0,0,0,0,0,0,0,0,0,0
"2011","Medway","E06000035","Rural hamlet and isolated dwellings",1139,956,436,520,4,38,8,30,119,101,18,22
"2011","Medway","E06000035","Rural hamlet and isolated dwellings in a sparse setting",0,0,0,0,0,0,0,0,0,0,0,0
"2011","Milton Keynes","E06000042","Total",98584,56913,21157,35756,5985,17763,10801,6962,17066,15930,1136,857
"2011","Milton Keynes","E06000042","Urban (total)",89555,50510,18258,32252,5785,16853,10274,6579,15663,14633,1030,744
"2011","Milton Keynes","E06000042","Urban major conurbation",0,0,0,0,0,0,0,0,0,0,0,0
"2011","Milton Keynes","E06000042","Urban minor conurbation",0,0,0,0,0,0,0,0,0,0,0,0
"2011","Milton Keynes","E06000042","Urban city and town",89555,50510,18258,32252,5785,16853,10274,6579,15663,14633,1030,744
"2011","Milton Keynes","E06000042","Urban city and town in a sparse setting",0,0,0,0,0,0,0,0,0,0,0,0
"2011","Milton Keynes","E06000042","Rural (total)",9029,6403,2899,3504,200,910,527,383,1403,1297,106,113
"2011","Milton Keynes","E06000042","Rural town and fringe",4906,3263,1394,1869,157,519,258,261,919,867,52,48
"2011","Milton Keynes","E06000042","Rural town and fringe in a sparse setting",0,0,0,0,0,0,0,0,0,0,0,0
"2011","Milton Keynes","E06000042","Rural village",3609,2750,1343,1407,37,339,244,95,430,380,50,53
"2011","Milton Keynes","E06000042","Rural village in a sparse setting",0,0,0,0,0,0,0,0,0,0,0,0
"2011","Milton Keynes","E06000042","Rural hamlet and isolated dwellings",514,390,162,228,6,52,25,27,54,50,4,12
"2011","Milton Keynes","E06000042","Rural hamlet and isolated dwellings in a sparse setting",0,0,0,0,0,0,0,0,0,0,0,0
"2011","Portsmouth","E06000044","Total",85473,46897,20616,26281,825,15611,10001,5610,21098,19044,2054,1042
"2011","Portsmouth","E06000044","Urban (total)",85473,46897,20616,26281,825,15611,10001,5610,21098,19044,2054,1042
"2011","Portsmouth","E06000044","Urban major conurbation",0,0,0,0,0,0,0,0,0,0,0,0
"2011","Portsmouth","E06000044","Urban minor conurbation",0,0,0,0,0,0,0,0,0,0,0,0
"2011","Portsmouth","E06000044","Urban city and town",85473,46897,20616,26281,825,15611,10001,5610,21098,19044,2054,1042
"2011","Portsmouth","E06000044","Urban city and town in a sparse setting",0,0,0,0,0,0,0,0,0,0,0,0
"2011","Portsmouth","E06000044","Rural (total)",0,0,0,0,0,0,0,0,0,0,0,0
"2011","Portsmouth","E06000044","Rural town and fringe",0,0,0,0,0,0,0,0,0,0,0,0
"2011","Portsmouth","E06000044","Rural town and fringe in a sparse setting",0,0,0,0,0,0,0,0,0,0,0,0
"2011","Portsmouth","E06000044","Rural village",0,0,0,0,0,0,0,0,0,0,0,0
"2011","Portsmouth","E06000044","Rural village in a sparse setting",0,0,0,0,0,0,0,0,0,0,0,0
"2011","Portsmouth","E06000044","Rural hamlet and isolated dwellings",0,0,0,0,0,0,0,0,0,0,0,0
"2011","Portsmouth","E06000044","Rural hamlet and isolated dwellings in a sparse setting",0,0,0,0,0,0,0,0,0,0,0,0
"2011","Reading","E06000038","Total",62869,34479,14222,20257,1130,10242,6322,3920,16394,15517,877,624
"2011","Reading","E06000038","Urban (total)",62633,34433,14214,20219,1118,10181,6321,3860,16280,15405,875,621
"2011","Reading","E06000038","Urban major conurbation",0,0,0,0,0,0,0,0,0,0,0,0
"2011","Reading","E06000038","Urban minor conurbation",0,0,0,0,0,0,0,0,0,0,0,0
"2011","Reading","E06000038","Urban city and town",62633,34433,14214,20219,1118,10181,6321,3860,16280,15405,875,621
"2011","Reading","E06000038","Urban city and town in a sparse setting",0,0,0,0,0,0,0,0,0,0,0,0
"2011","Reading","E06000038","Rural (total)",236,46,8,38,12,61,1,60,114,112,2,3
"2011","Reading","E06000038","Rural town and fringe",236,46,8,38,12,61,1,60,114,112,2,3
"2011","Reading","E06000038","Rural town and fringe in a sparse setting",0,0,0,0,0,0,0,0,0,0,0,0
"2011","Reading","E06000038","Rural village",0,0,0,0,0,0,0,0,0,0,0,0
"2011","Reading","E06000038","Rural village in a sparse setting",0,0,0,0,0,0,0,0,0,0,0,0
"2011","Reading","E06000038","Rural hamlet and isolated dwellings",0,0,0,0,0,0,0,0,0,0,0,0
"2011","Reading","E06000038","Rural hamlet and isolated dwellings in a sparse setting",0,0,0,0,0,0,0,0,0,0,0,0
"2011","Slough","E06000039","Total",50766,26755,9502,17253,686,10476,6656,3820,12348,11713,635,501
"2011","Slough","E06000039","Urban (total)",50766,26755,9502,17253,686,10476,6656,3820,12348,11713,635,501
"2011","Slough","E06000039","Urban major conurbation",0,0,0,0,0,0,0,0,0,0,0,0
"2011","Slough","E06000039","Urban minor conurbation",0,0,0,0,0,0,0,0,0,0,0,0
"2011","Slough","E06000039","Urban city and town",50766,26755,9502,17253,686,10476,6656,3820,12348,11713,635,501
"2011","Slough","E06000039","Urban city and town in a sparse setting",0,0,0,0,0,0,0,0,0,0,0,0
"2011","Slough","E06000039","Rural (total)",0,0,0,0,0,0,0,0,0,0,0,0
"2011","Slough","E06000039","Rural town and fringe",0,0,0,0,0,0,0,0,0,0,0,0
"2011","Slough","E06000039","Rural town and fringe in a sparse setting",0,0,0,0,0,0,0,0,0,0,0,0
"2011","Slough","E06000039","Rural village",0,0,0,0,0,0,0,0,0,0,0,0
"2011","Slough","E06000039","Rural village in a sparse setting",0,0,0,0,0,0,0,0,0,0,0,0
"2011","Slough","E06000039","Rural hamlet and isolated dwellings",0,0,0,0,0,0,0,0,0,0,0,0
"2011","Slough","E06000039","Rural hamlet and isolated dwellings in a sparse setting",0,0,0,0,0,0,0,0,0,0,0,0
"2011","Southampton","E06000045","Total",98254,48873,21286,27587,1013,22867,16633,6234,24449,23007,1442,1052
"2011","Southampton","E06000045","Urban (total)",98254,48873,21286,27587,1013,22867,16633,6234,24449,23007,1442,1052
"2011","Southampton","E06000045","Urban major conurbation",0,0,0,0,0,0,0,0,0,0,0,0
"2011","Southampton","E06000045","Urban minor conurbation",0,0,0,0,0,0,0,0,0,0,0,0
"2011","Southampton","E06000045","Urban city and town",98254,48873,21286,27587,1013,22867,16633,6234,24449,23007,1442,1052
"2011","Southampton","E06000045","Urban city and town in a sparse setting",0,0,0,0,0,0,0,0,0,0,0,0
"2011","Southampton","E06000045","Rural (total)",0,0,0,0,0,0,0,0,0,0,0,0
"2011","Southampton","E06000045","Rural town and fringe",0,0,0,0,0,0,0,0,0,0,0,0
"2011","Southampton","E06000045","Rural town and fringe in a sparse setting",0,0,0,0,0,0,0,0,0,0,0,0
"2011","Southampton","E06000045","Rural village",0,0,0,0,0,0,0,0,0,0,0,0
"2011","Southampton","E06000045","Rural village in a sparse setting",0,0,0,0,0,0,0,0,0,0,0,0
"2011","Southampton","E06000045","Rural hamlet and isolated dwellings",0,0,0,0,0,0,0,0,0,0,0,0
"2011","Southampton","E06000045","Rural hamlet and isolated dwellings in a sparse setting",0,0,0,0,0,0,0,0,0,0,0,0
"2011","West Berkshire","E06000037","Total",62340,43435,19455,23980,695,8628,575,8053,8555,7457,1098,1027
"2011","West Berkshire","E06000037","Urban (total)",39612,28052,12021,16031,504,5659,395,5264,5063,4599,464,334
"2011","West Berkshire","E06000037","Urban major conurbation",0,0,0,0,0,0,0,0,0,0,0,0
"2011","West Berkshire","E06000037","Urban minor conurbation",0,0,0,0,0,0,0,0,0,0,0,0
"2011","West Berkshire","E06000037","Urban city and town",39612,28052,12021,16031,504,5659,395,5264,5063,4599,464,334
"2011","West Berkshire","E06000037","Urban city and town in a sparse setting",0,0,0,0,0,0,0,0,0,0,0,0
"2011","West Berkshire","E06000037","Rural (total)",22728,15383,7434,7949,191,2969,180,2789,3492,2858,634,693
"2011","West Berkshire","E06000037","Rural town and fringe",10011,6810,3138,3672,100,1670,98,1572,1266,1131,135,165
"2011","West Berkshire","E06000037","Rural town and fringe in a sparse setting",0,0,0,0,0,0,0,0,0,0,0,0
"2011","West Berkshire","E06000037","Rural village",7466,5174,2508,2666,60,857,59,798,1155,809,346,220
"2011","West Berkshire","E06000037","Rural village in a sparse setting",0,0,0,0,0,0,0,0,0,0,0,0
"2011","West Berkshire","E06000037","Rural hamlet and isolated dwellings",5251,3399,1788,1611,31,442,23,419,1071,918,153,308
"2011","West Berkshire","E06000037","Rural hamlet and isolated dwellings in a sparse setting",0,0,0,0,0,0,0,0,0,0,0,0
"2011","Windsor and Maidenhead","E06000040","Total",58349,39676,19013,20663,358,7748,711,7037,9432,8099,1333,1135
"2011","Windsor and Maidenhead","E06000040","Urban (total)",52202,35474,16991,18483,340,7008,612,6396,8411,7337,1074,969
"2011","Windsor and Maidenhead","E06000040","Urban major conurbation",133,120,45,75,0,0,0,0,12,7,5,1
"2011","Windsor and Maidenhead","E06000040","Urban minor conurbation",0,0,0,0,0,0,0,0,0,0,0,0
"2011","Windsor and Maidenhead","E06000040","Urban city and town",52069,35354,16946,18408,340,7008,612,6396,8399,7330,1069,968
"2011","Windsor and Maidenhead","E06000040","Urban city and town in a sparse setting",0,0,0,0,0,0,0,0,0,0,0,0
"2011","Windsor and Maidenhead","E06000040","Rural (total)",6147,4202,2022,2180,18,740,99,641,1021,762,259,166
"2011","Windsor and Maidenhead","E06000040","Rural town and fringe",2909,1949,863,1086,11,464,75,389,440,387,53,45
"2011","Windsor and Maidenhead","E06000040","Rural town and fringe in a sparse setting",0,0,0,0,0,0,0,0,0,0,0,0
"2011","Windsor and Maidenhead","E06000040","Rural village",2450,1659,834,825,7,251,22,229,452,279,173,81
"2011","Windsor and Maidenhead","E06000040","Rural village in a sparse setting",0,0,0,0,0,0,0,0,0,0,0,0
"2011","Windsor and Maidenhead","E06000040","Rural hamlet and isolated dwellings",788,594,325,269,0,25,2,23,129,96,33,40
"2011","Windsor and Maidenhead","E06000040","Rural hamlet and isolated dwellings in a sparse setting",0,0,0,0,0,0,0,0,0,0,0,0
"2011","Wokingham","E06000041","Total",60332,48103,21461,26642,679,4236,2845,1391,6755,6001,754,559
"2011","Wokingham","E06000041","Urban (total)",49568,39838,17553,22285,499,3432,2218,1214,5419,4814,605,380
"2011","Wokingham","E06000041","Urban major conurbation",0,0,0,0,0,0,0,0,0,0,0,0
"2011","Wokingham","E06000041","Urban minor conurbation",0,0,0,0,0,0,0,0,0,0,0,0
"2011","Wokingham","E06000041","Urban city and town",49568,39838,17553,22285,499,3432,2218,1214,5419,4814,605,380
"2011","Wokingham","E06000041","Urban city and town in a sparse setting",0,0,0,0,0,0,0,0,0,0,0,0
"2011","Wokingham","E06000041","Rural (total)",10764,8265,3908,4357,180,804,627,177,1336,1187,149,179
"2011","Wokingham","E06000041","Rural town and fringe",6650,5210,2416,2794,118,503,378,125,772,720,52,47
"2011","Wokingham","E06000041","Rural town and fringe in a sparse setting",0,0,0,0,0,0,0,0,0,0,0,0
"2011","Wokingham","E06000041","Rural village",2046,1534,714,820,53,214,181,33,208,180,28,37
"2011","Wokingham","E06000041","Rural village in a sparse setting",0,0,0,0,0,0,0,0,0,0,0,0
"2011","Wokingham","E06000041","Rural hamlet and isolated dwellings",2068,1521,778,743,9,87,68,19,356,287,69,95
"2011","Wokingham","E06000041","Rural hamlet and isolated dwellings in a sparse setting",0,0,0,0,0,0,0,0,0,0,0,0
"2011","Aylesbury Vale","E07000004","Total",69406,49702,21607,28095,600,8982,2333,6649,9234,8096,1138,888
"2011","Aylesbury Vale","E07000004","Urban (total)",35019,23581,9178,14403,373,5204,1427,3777,5542,5064,478,319
"2011","Aylesbury Vale","E07000004","Urban major conurbation",0,0,0,0,0,0,0,0,0,0,0,0
"2011","Aylesbury Vale","E07000004","Urban minor conurbation",0,0,0,0,0,0,0,0,0,0,0,0
"2011","Aylesbury Vale","E07000004","Urban city and town",35019,23581,9178,14403,373,5204,1427,3777,5542,5064,478,319
"2011","Aylesbury Vale","E07000004","Urban city and town in a sparse setting",0,0,0,0,0,0,0,0,0,0,0,0
"2011","Aylesbury Vale","E07000004","Rural (total)",34387,26121,12429,13692,227,3778,906,2872,3692,3032,660,569
"2011","Aylesbury Vale","E07000004","Rural town and fringe",16937,12691,5941,6750,131,2222,508,1714,1647,1335,312,246
"2011","Aylesbury Vale","E07000004","Rural town and fringe in a sparse setting",0,0,0,0,0,0,0,0,0,0,0,0
"2011","Aylesbury Vale","E07000004","Rural village",14179,11002,5250,5752,87,1379,361,1018,1491,1274,217,220
"2011","Aylesbury Vale","E07000004","Rural village in a sparse setting",0,0,0,0,0,0,0,0,0,0,0,0
"2011","Aylesbury Vale","E07000004","Rural hamlet and isolated dwellings",3271,2428,1238,1190,9,177,37,140,554,423,131,103
"2011","Aylesbury Vale","E07000004","Rural hamlet and isolated dwellings in a sparse setting",0,0,0,0,0,0,0,0,0,0,0,0
"2011","Chiltern","E07000005","Total",36946,28418,15191,13227,257,4573,657,3916,3314,3039,275,384
"2011","Chiltern","E07000005","Urban (total)",26526,20019,10478,9541,206,3631,541,3090,2437,2242,195,233
"2011","Chiltern","E07000005","Urban major conurbation",0,0,0,0,0,0,0,0,0,0,0,0
"2011","Chiltern","E07000005","Urban minor conurbation",0,0,0,0,0,0,0,0,0,0,0,0
"2011","Chiltern","E07000005","Urban city and town",26526,20019,10478,9541,206,3631,541,3090,2437,2242,195,233
"2011","Chiltern","E07000005","Urban city and town in a sparse setting",0,0,0,0,0,0,0,0,0,0,0,0
"2011","Chiltern","E07000005","Rural (total)",10420,8399,4713,3686,51,942,116,826,877,797,80,151
"2011","Chiltern","E07000005","Rural town and fringe",5761,4558,2457,2101,32,608,75,533,500,466,34,63
"2011","Chiltern","E07000005","Rural town and fringe in a sparse setting",0,0,0,0,0,0,0,0,0,0,0,0
"2011","Chiltern","E07000005","Rural village",3074,2512,1447,1065,13,287,34,253,212,187,25,50
"2011","Chiltern","E07000005","Rural village in a sparse setting",0,0,0,0,0,0,0,0,0,0,0,0
"2011","Chiltern","E07000005","Rural hamlet and isolated dwellings",1585,1329,809,520,6,47,7,40,165,144,21,38
"2011","Chiltern","E07000005","Rural hamlet and isolated dwellings in a sparse setting",0,0,0,0,0,0,0,0,0,0,0,0
"2011","South Bucks","E07000006","Total",26514,19453,10099,9354,402,3266,261,3005,3011,2653,358,382
"2011","South Bucks","E07000006","Urban (total)",17998,13249,6935,6314,218,2208,156,2052,2068,1883,185,255
"2011","South Bucks","E07000006","Urban major conurbation",571,428,223,205,2,59,9,50,78,66,12,4
"2011","South Bucks","E07000006","Urban minor conurbation",0,0,0,0,0,0,0,0,0,0,0,0
"2011","South Bucks","E07000006","Urban city and town",17427,12821,6712,6109,216,2149,147,2002,1990,1817,173,251
"2011","South Bucks","E07000006","Urban city and town in a sparse setting",0,0,0,0,0,0,0,0,0,0,0,0
"2011","South Bucks","E07000006","Rural (total)",8516,6204,3164,3040,184,1058,105,953,943,770,173,127
"2011","South Bucks","E07000006","Rural town and fringe",5618,3943,1990,1953,162,958,85,873,504,452,52,51
"2011","South Bucks","E07000006","Rural town and fringe in a sparse setting",0,0,0,0,0,0,0,0,0,0,0,0
"2011","South Bucks","E07000006","Rural village",1327,1049,552,497,9,56,3,53,184,158,26,29
"2011","South Bucks","E07000006","Rural village in a sparse setting",0,0,0,0,0,0,0,0,0,0,0,0
"2011","South Bucks","E07000006","Rural hamlet and isolated dwellings",1571,1212,622,590,13,44,17,27,255,160,95,47
"2011","South Bucks","E07000006","Rural hamlet and isolated dwellings in a sparse setting",0,0,0,0,0,0,0,0,0,0,0,0
"2011","Wycombe","E07000007","Total",67861,47279,21887,25392,687,8650,5792,2858,10316,8900,1416,929
"2011","Wycombe","E07000007","Urban (total)",54788,37593,16737,20856,616,7277,4841,2436,8655,7612,1043,647
"2011","Wycombe","E07000007","Urban major conurbation",0,0,0,0,0,0,0,0,0,0,0,0
"2011","Wycombe","E07000007","Urban minor conurbation",0,0,0,0,0,0,0,0,0,0,0,0
"2011","Wycombe","E07000007","Urban city and town",54788,37593,16737,20856,616,7277,4841,2436,8655,7612,1043,647
"2011","Wycombe","E07000007","Urban city and town in a sparse setting",0,0,0,0,0,0,0,0,0,0,0,0
"2011","Wycombe","E07000007","Rural (total)",13073,9686,5150,4536,71,1373,951,422,1661,1288,373,282
"2011","Wycombe","E07000007","Rural town and fringe",5896,4136,2103,2033,43,1028,751,277,599,536,63,90
"2011","Wycombe","E07000007","Rural town and fringe in a sparse setting",0,0,0,0,0,0,0,0,0,0,0,0
"2011","Wycombe","E07000007","Rural village",3404,2650,1391,1259,7,175,117,58,509,297,212,63
"2011","Wycombe","E07000007","Rural village in a sparse setting",0,0,0,0,0,0,0,0,0,0,0,0
"2011","Wycombe","E07000007","Rural hamlet and isolated dwellings",3773,2900,1656,1244,21,170,83,87,553,455,98,129
"2011","Wycombe","E07000007","Rural hamlet and isolated dwellings in a sparse setting",0,0,0,0,0,0,0,0,0,0,0,0
"2011","Eastbourne","E07000061","Total",45012,27788,15071,12717,295,5953,3348,2605,10494,9747,747,482
"2011","Eastbourne","E07000061","Urban (total)",45012,27788,15071,12717,295,5953,3348,2605,10494,9747,747,482
"2011","Eastbourne","E07000061","Urban major conurbation",0,0,0,0,0,0,0,0,0,0,0,0
"2011","Eastbourne","E07000061","Urban minor conurbation",0,0,0,0,0,0,0,0,0,0,0,0
"2011","Eastbourne","E07000061","Urban city and town",45012,27788,15071,12717,295,5953,3348,2605,10494,9747,747,482
"2011","Eastbourne","E07000061","Urban city and town in a sparse setting",0,0,0,0,0,0,0,0,0,0,0,0
"2011","Eastbourne","E07000061","Rural (total)",0,0,0,0,0,0,0,0,0,0,0,0
"2011","Eastbourne","E07000061","Rural town and fringe",0,0,0,0,0,0,0,0,0,0,0,0
"2011","Eastbourne","E07000061","Rural town and fringe in a sparse setting",0,0,0,0,0,0,0,0,0,0,0,0
"2011","Eastbourne","E07000061","Rural village",0,0,0,0,0,0,0,0,0,0,0,0
"2011","Eastbourne","E07000061","Rural village in a sparse setting",0,0,0,0,0,0,0,0,0,0,0,0
"2011","Eastbourne","E07000061","Rural hamlet and isolated dwellings",0,0,0,0,0,0,0,0,0,0,0,0
"2011","Eastbourne","E07000061","Rural hamlet and isolated dwellings in a sparse setting",0,0,0,0,0,0,0,0,0,0,0,0
"2011","Hastings","E07000062","Total",41159,22706,11071,11635,193,5988,763,5225,11863,11191,672,409
"2011","Hastings","E07000062","Urban (total)",41159,22706,11071,11635,193,5988,763,5225,11863,11191,672,409
"2011","Hastings","E07000062","Urban major conurbation",0,0,0,0,0,0,0,0,0,0,0,0
"2011","Hastings","E07000062","Urban minor conurbation",0,0,0,0,0,0,0,0,0,0,0,0
"2011","Hastings","E07000062","Urban city and town",41159,22706,11071,11635,193,5988,763,5225,11863,11191,672,409
"2011","Hastings","E07000062","Urban city and town in a sparse setting",0,0,0,0,0,0,0,0,0,0,0,0
"2011","Hastings","E07000062","Rural (total)",0,0,0,0,0,0,0,0,0,0,0,0
"2011","Hastings","E07000062","Rural town and fringe",0,0,0,0,0,0,0,0,0,0,0,0
"2011","Hastings","E07000062","Rural town and fringe in a sparse setting",0,0,0,0,0,0,0,0,0,0,0,0
"2011","Hastings","E07000062","Rural village",0,0,0,0,0,0,0,0,0,0,0,0
"2011","Hastings","E07000062","Rural village in a sparse setting",0,0,0,0,0,0,0,0,0,0,0,0
"2011","Hastings","E07000062","Rural hamlet and isolated dwellings",0,0,0,0,0,0,0,0,0,0,0,0
"2011","Hastings","E07000062","Rural hamlet and isolated dwellings in a sparse setting",0,0,0,0,0,0,0,0,0,0,0,0
"2011","Lewes","E07000063","Total",42181,30648,16797,13851,285,4609,3196,1413,6108,5557,551,531
"2011","Lewes","E07000063","Urban (total)",33045,23813,12846,10967,217,3734,2544,1190,4960,4558,402,321
"2011","Lewes","E07000063","Urban major conurbation",0,0,0,0,0,0,0,0,0,0,0,0
"2011","Lewes","E07000063","Urban minor conurbation",0,0,0,0,0,0,0,0,0,0,0,0
"2011","Lewes","E07000063","Urban city and town",33045,23813,12846,10967,217,3734,2544,1190,4960,4558,402,321
"2011","Lewes","E07000063","Urban city and town in a sparse setting",0,0,0,0,0,0,0,0,0,0,0,0
"2011","Lewes","E07000063","Rural (total)",9136,6835,3951,2884,68,875,652,223,1148,999,149,210
"2011","Lewes","E07000063","Rural town and fringe",3445,2765,1689,1076,28,300,230,70,306,263,43,46
"2011","Lewes","E07000063","Rural town and fringe in a sparse setting",0,0,0,0,0,0,0,0,0,0,0,0
"2011","Lewes","E07000063","Rural village",4185,3020,1680,1340,31,482,345,137,545,477,68,107
"2011","Lewes","E07000063","Rural village in a sparse setting",0,0,0,0,0,0,0,0,0,0,0,0
"2011","Lewes","E07000063","Rural hamlet and isolated dwellings",1506,1050,582,468,9,93,77,16,297,259,38,57
"2011","Lewes","E07000063","Rural hamlet and isolated dwellings in a sparse setting",0,0,0,0,0,0,0,0,0,0,0,0
"2011","Rother","E07000064","Total",40877,30060,18554,11506,219,4242,712,3530,5742,5190,552,614
"2011","Rother","E07000064","Urban (total)",20549,14821,9564,5257,114,1877,304,1573,3510,3272,238,227
"2011","Rother","E07000064","Urban major conurbation",0,0,0,0,0,0,0,0,0,0,0,0
"2011","Rother","E07000064","Urban minor conurbation",0,0,0,0,0,0,0,0,0,0,0,0
"2011","Rother","E07000064","Urban city and town",20549,14821,9564,5257,114,1877,304,1573,3510,3272,238,227
"2011","Rother","E07000064","Urban city and town in a sparse setting",0,0,0,0,0,0,0,0,0,0,0,0
"2011","Rother","E07000064","Rural (total)",20328,15239,8990,6249,105,2365,408,1957,2232,1918,314,387
"2011","Rother","E07000064","Rural town and fringe",8015,5593,3348,2245,57,1194,216,978,1033,886,147,138
"2011","Rother","E07000064","Rural town and fringe in a sparse setting",0,0,0,0,0,0,0,0,0,0,0,0
"2011","Rother","E07000064","Rural village",7322,5593,3191,2402,34,961,161,800,622,540,82,112
"2011","Rother","E07000064","Rural village in a sparse setting",0,0,0,0,0,0,0,0,0,0,0,0
"2011","Rother","E07000064","Rural hamlet and isolated dwellings",4991,4053,2451,1602,14,210,31,179,577,492,85,137
"2011","Rother","E07000064","Rural hamlet and isolated dwellings in a sparse setting",0,0,0,0,0,0,0,0,0,0,0,0
"2011","Wealden","E07000065","Total",62676,49355,26483,22872,503,4808,2956,1852,6973,6214,759,1037
"2011","Wealden","E07000065","Urban (total)",34784,27250,14080,13170,322,3066,1788,1278,3762,3371,391,384
"2011","Wealden","E07000065","Urban major conurbation",0,0,0,0,0,0,0,0,0,0,0,0
"2011","Wealden","E07000065","Urban minor conurbation",0,0,0,0,0,0,0,0,0,0,0,0
"2011","Wealden","E07000065","Urban city and town",34784,27250,14080,13170,322,3066,1788,1278,3762,3371,391,384
"2011","Wealden","E07000065","Urban city and town in a sparse setting",0,0,0,0,0,0,0,0,0,0,0,0
"2011","Wealden","E07000065","Rural (total)",27892,22105,12403,9702,181,1742,1168,574,3211,2843,368,653
"2011","Wealden","E07000065","Rural town and fringe",10320,8073,4664,3409,101,751,542,209,1259,1136,123,136
"2011","Wealden","E07000065","Rural town and fringe in a sparse setting",0,0,0,0,0,0,0,0,0,0,0,0
"2011","Wealden","E07000065","Rural village",9504,7571,4233,3338,44,694,478,216,980,852,128,215
"2011","Wealden","E07000065","Rural village in a sparse setting",0,0,0,0,0,0,0,0,0,0,0,0
"2011","Wealden","E07000065","Rural hamlet and isolated dwellings",8068,6461,3506,2955,36,297,148,149,972,855,117,302
"2011","Wealden","E07000065","Rural hamlet and isolated dwellings in a sparse setting",0,0,0,0,0,0,0,0,0,0,0,0
"2011","Basingstoke and Deane","E07000084","Total",69315,46936,19517,27419,958,12346,540,11806,8172,7473,699,903
"2011","Basingstoke and Deane","E07000084","Urban (total)",50997,33740,12922,20818,826,9964,414,9550,6084,5631,453,383
"2011","Basingstoke and Deane","E07000084","Urban major conurbation",0,0,0,0,0,0,0,0,0,0,0,0
"2011","Basingstoke and Deane","E07000084","Urban minor conurbation",0,0,0,0,0,0,0,0,0,0,0,0
"2011","Basingstoke and Deane","E07000084","Urban city and town",50997,33740,12922,20818,826,9964,414,9550,6084,5631,453,383
"2011","Basingstoke and Deane","E07000084","Urban city and town in a sparse setting",0,0,0,0,0,0,0,0,0,0,0,0
"2011","Basingstoke and Deane","E07000084","Rural (total)",18318,13196,6595,6601,132,2382,126,2256,2088,1842,246,520
"2011","Basingstoke and Deane","E07000084","Rural town and fringe",9301,6869,3300,3569,69,1423,79,1344,805,726,79,135
"2011","Basingstoke and Deane","E07000084","Rural town and fringe in a sparse setting",0,0,0,0,0,0,0,0,0,0,0,0
"2011","Basingstoke and Deane","E07000084","Rural village",4925,3547,1783,1764,50,690,34,656,507,447,60,131
"2011","Basingstoke and Deane","E07000084","Rural village in a sparse setting",0,0,0,0,0,0,0,0,0,0,0,0
"2011","Basingstoke and Deane","E07000084","Rural hamlet and isolated dwellings",4092,2780,1512,1268,13,269,13,256,776,669,107,254
"2011","Basingstoke and Deane","E07000084","Rural hamlet and isolated dwellings in a sparse setting",0,0,0,0,0,0,0,0,0,0,0,0
"2011","East Hampshire","E07000085","Total",47258,34919,17520,17399,431,5681,742,4939,5517,4636,881,710
"2011","East Hampshire","E07000085","Urban (total)",30826,22556,10959,11597,285,4098,561,3537,3560,2957,603,327
"2011","East Hampshire","E07000085","Urban major conurbation",0,0,0,0,0,0,0,0,0,0,0,0
"2011","East Hampshire","E07000085","Urban minor conurbation",0,0,0,0,0,0,0,0,0,0,0,0
"2011","East Hampshire","E07000085","Urban city and town",30826,22556,10959,11597,285,4098,561,3537,3560,2957,603,327
"2011","East Hampshire","E07000085","Urban city and town in a sparse setting",0,0,0,0,0,0,0,0,0,0,0,0
"2011","East Hampshire","E07000085","Rural (total)",16432,12363,6561,5802,146,1583,181,1402,1957,1679,278,383
"2011","East Hampshire","E07000085","Rural town and fringe",6989,5281,2744,2537,58,791,93,698,766,696,70,93
"2011","East Hampshire","E07000085","Rural town and fringe in a sparse setting",0,0,0,0,0,0,0,0,0,0,0,0
"2011","East Hampshire","E07000085","Rural village",5327,3899,2023,1876,70,608,68,540,597,495,102,153
"2011","East Hampshire","E07000085","Rural village in a sparse setting",0,0,0,0,0,0,0,0,0,0,0,0
"2011","East Hampshire","E07000085","Rural hamlet and isolated dwellings",4116,3183,1794,1389,18,184,20,164,594,488,106,137
"2011","East Hampshire","E07000085","Rural hamlet and isolated dwellings in a sparse setting",0,0,0,0,0,0,0,0,0,0,0,0
"2011","Eastleigh","E07000086","Total",52177,38362,17228,21134,552,6411,573,5838,6438,5864,574,414
"2011","Eastleigh","E07000086","Urban (total)",46985,34903,15616,19287,523,5629,490,5139,5570,5072,498,360
"2011","Eastleigh","E07000086","Urban major conurbation",0,0,0,0,0,0,0,0,0,0,0,0
"2011","Eastleigh","E07000086","Urban minor conurbation",0,0,0,0,0,0,0,0,0,0,0,0
"2011","Eastleigh","E07000086","Urban city and town",46985,34903,15616,19287,523,5629,490,5139,5570,5072,498,360
"2011","Eastleigh","E07000086","Urban city and town in a sparse setting",0,0,0,0,0,0,0,0,0,0,0,0
"2011","Eastleigh","E07000086","Rural (total)",5192,3459,1612,1847,29,782,83,699,868,792,76,54
"2011","Eastleigh","E07000086","Rural town and fringe",4873,3189,1444,1745,28,778,80,698,828,756,72,50
"2011","Eastleigh","E07000086","Rural town and fringe in a sparse setting",0,0,0,0,0,0,0,0,0,0,0,0
"2011","Eastleigh","E07000086","Rural village",111,90,52,38,0,1,1,0,19,18,1,1
"2011","Eastleigh","E07000086","Rural village in a sparse setting",0,0,0,0,0,0,0,0,0,0,0,0
"2011","Eastleigh","E07000086","Rural hamlet and isolated dwellings",208,180,116,64,1,3,2,1,21,18,3,3
"2011","Eastleigh","E07000086","Rural hamlet and isolated dwellings in a sparse setting",0,0,0,0,0,0,0,0,0,0,0,0
"2011","Fareham","E07000087","Total",46579,37460,18279,19181,277,3785,2370,1415,4645,3906,739,412
"2011","Fareham","E07000087","Urban (total)",46363,37291,18191,19100,277,3778,2364,1414,4612,3878,734,405
"2011","Fareham","E07000087","Urban major conurbation",0,0,0,0,0,0,0,0,0,0,0,0
"2011","Fareham","E07000087","Urban minor conurbation",0,0,0,0,0,0,0,0,0,0,0,0
"2011","Fareham","E07000087","Urban city and town",46363,37291,18191,19100,277,3778,2364,1414,4612,3878,734,405
"2011","Fareham","E07000087","Urban city and town in a sparse setting",0,0,0,0,0,0,0,0,0,0,0,0
"2011","Fareham","E07000087","Rural (total)",216,169,88,81,0,7,6,1,33,28,5,7
"2011","Fareham","E07000087","Rural town and fringe",0,0,0,0,0,0,0,0,0,0,0,0
"2011","Fareham","E07000087","Rural town and fringe in a sparse setting",0,0,0,0,0,0,0,0,0,0,0,0
"2011","Fareham","E07000087","Rural village",0,0,0,0,0,0,0,0,0,0,0,0
"2011","Fareham","E07000087","Rural village in a sparse setting",0,0,0,0,0,0,0,0,0,0,0,0
"2011","Fareham","E07000087","Rural hamlet and isolated dwellings",216,169,88,81,0,7,6,1,33,28,5,7
"2011","Fareham","E07000087","Rural hamlet and isolated dwellings in a sparse setting",0,0,0,0,0,0,0,0,0,0,0,0
"2011","Gosport","E07000088","Total",35430,23115,10413,12702,381,5815,3297,2518,5777,4506,1271,342
"2011","Gosport","E07000088","Urban (total)",35295,23085,10407,12678,333,5793,3295,2498,5742,4474,1268,342
"2011","Gosport","E07000088","Urban major conurbation",0,0,0,0,0,0,0,0,0,0,0,0
"2011","Gosport","E07000088","Urban minor conurbation",0,0,0,0,0,0,0,0,0,0,0,0
"2011","Gosport","E07000088","Urban city and town",35295,23085,10407,12678,333,5793,3295,2498,5742,4474,1268,342
"2011","Gosport","E07000088","Urban city and town in a sparse setting",0,0,0,0,0,0,0,0,0,0,0,0
"2011","Gosport","E07000088","Rural (total)",135,30,6,24,48,22,2,20,35,32,3,0
"2011","Gosport","E07000088","Rural town and fringe",135,30,6,24,48,22,2,20,35,32,3,0
"2011","Gosport","E07000088","Rural town and fringe in a sparse setting",0,0,0,0,0,0,0,0,0,0,0,0
"2011","Gosport","E07000088","Rural village",0,0,0,0,0,0,0,0,0,0,0,0
"2011","Gosport","E07000088","Rural village in a sparse setting",0,0,0,0,0,0,0,0,0,0,0,0
"2011","Gosport","E07000088","Rural hamlet and isolated dwellings",0,0,0,0,0,0,0,0,0,0,0,0
"2011","Gosport","E07000088","Rural hamlet and isolated dwellings in a sparse setting",0,0,0,0,0,0,0,0,0,0,0,0
"2011","Hart","E07000089","Total",35510,27747,12610,15137,406,2718,215,2503,4286,3380,906,353
"2011","Hart","E07000089","Urban (total)",25064,20372,9039,11333,306,1517,102,1415,2701,2383,318,168
"2011","Hart","E07000089","Urban major conurbation",0,0,0,0,0,0,0,0,0,0,0,0
"2011","Hart","E07000089","Urban minor conurbation",0,0,0,0,0,0,0,0,0,0,0,0
"2011","Hart","E07000089","Urban city and town",25064,20372,9039,11333,306,1517,102,1415,2701,2383,318,168
"2011","Hart","E07000089","Urban city and town in a sparse setting",0,0,0,0,0,0,0,0,0,0,0,0
"2011","Hart","E07000089","Rural (total)",10446,7375,3571,3804,100,1201,113,1088,1585,997,588,185
"2011","Hart","E07000089","Rural town and fringe",6259,4579,2128,2451,77,822,71,751,720,585,135,61
"2011","Hart","E07000089","Rural town and fringe in a sparse setting",0,0,0,0,0,0,0,0,0,0,0,0
"2011","Hart","E07000089","Rural village",2747,1762,893,869,17,258,19,239,641,233,408,69
"2011","Hart","E07000089","Rural village in a sparse setting",0,0,0,0,0,0,0,0,0,0,0,0
"2011","Hart","E07000089","Rural hamlet and isolated dwellings",1440,1034,550,484,6,121,23,98,224,179,45,55
"2011","Hart","E07000089","Rural hamlet and isolated dwellings in a sparse setting",0,0,0,0,0,0,0,0,0,0,0,0
"2011","Havant","E07000090","Total",51311,35387,18169,17218,281,10037,5300,4737,5087,4510,577,519
"2011","Havant","E07000090","Urban (total)",50515,34662,17749,16913,281,10026,5294,4732,5039,4472,567,507
"2011","Havant","E07000090","Urban major conurbation",0,0,0,0,0,0,0,0,0,0,0,0
"2011","Havant","E07000090","Urban minor conurbation",0,0,0,0,0,0,0,0,0,0,0,0
"2011","Havant","E07000090","Urban city and town",50515,34662,17749,16913,281,10026,5294,4732,5039,4472,567,507
"2011","Havant","E07000090","Urban city and town in a sparse setting",0,0,0,0,0,0,0,0,0,0,0,0
"2011","Havant","E07000090","Rural (total)",796,725,420,305,0,11,6,5,48,38,10,12
"2011","Havant","E07000090","Rural town and fringe",0,0,0,0,0,0,0,0,0,0,0,0
"2011","Havant","E07000090","Rural town and fringe in a sparse setting",0,0,0,0,0,0,0,0,0,0,0,0
"2011","Havant","E07000090","Rural village",736,674,383,291,0,11,6,5,41,33,8,10
"2011","Havant","E07000090","Rural village in a sparse setting",0,0,0,0,0,0,0,0,0,0,0,0
"2011","Havant","E07000090","Rural hamlet and isolated dwellings",60,51,37,14,0,0,0,0,7,5,2,2
"2011","Havant","E07000090","Rural hamlet and isolated dwellings in a sparse setting",0,0,0,0,0,0,0,0,0,0,0,0
"2011","New Forest","E07000091","Total",76839,57603,33430,24173,484,8440,5185,3255,9293,8153,1140,1019
"2011","New Forest","E07000091","Urban (total)",55736,41499,23476,18023,402,6861,4223,2638,6391,5721,670,583
"2011","New Forest","E07000091","Urban major conurbation",0,0,0,0,0,0,0,0,0,0,0,0
"2011","New Forest","E07000091","Urban minor conurbation",0,0,0,0,0,0,0,0,0,0,0,0
"2011","New Forest","E07000091","Urban city and town",55736,41499,23476,18023,402,6861,4223,2638,6391,5721,670,583
"2011","New Forest","E07000091","Urban city and town in a sparse setting",0,0,0,0,0,0,0,0,0,0,0,0
"2011","New Forest","E07000091","Rural (total)",21103,16104,9954,6150,82,1579,962,617,2902,2432,470,436
"2011","New Forest","E07000091","Rural town and fringe",11691,9020,5430,3590,52,997,601,396,1477,1240,237,145
"2011","New Forest","E07000091","Rural town and fringe in a sparse setting",0,0,0,0,0,0,0,0,0,0,0,0
"2011","New Forest","E07000091","Rural village",3959,3028,1947,1081,13,354,223,131,482,379,103,82
"2011","New Forest","E07000091","Rural village in a sparse setting",0,0,0,0,0,0,0,0,0,0,0,0
"2011","New Forest","E07000091","Rural hamlet and isolated dwellings",5453,4056,2577,1479,17,228,138,90,943,813,130,209
"2011","New Forest","E07000091","Rural hamlet and isolated dwellings in a sparse setting",0,0,0,0,0,0,0,0,0,0,0,0
"2011","Rushmoor","E07000092","Total",36344,23089,8434,14655,647,5927,771,5156,6379,4607,1772,302
"2011","Rushmoor","E07000092","Urban (total)",36297,23084,8431,14653,647,5923,771,5152,6345,4605,1740,298
"2011","Rushmoor","E07000092","Urban major conurbation",0,0,0,0,0,0,0,0,0,0,0,0
"2011","Rushmoor","E07000092","Urban minor conurbation",0,0,0,0,0,0,0,0,0,0,0,0
"2011","Rushmoor","E07000092","Urban city and town",36297,23084,8431,14653,647,5923,771,5152,6345,4605,1740,298
"2011","Rushmoor","E07000092","Urban city and town in a sparse setting",0,0,0,0,0,0,0,0,0,0,0,0
"2011","Rushmoor","E07000092","Rural (total)",47,5,3,2,0,4,0,4,34,2,32,4
"2011","Rushmoor","E07000092","Rural town and fringe",47,5,3,2,0,4,0,4,34,2,32,4
"2011","Rushmoor","E07000092","Rural town and fringe in a sparse setting",0,0,0,0,0,0,0,0,0,0,0,0
"2011","Rushmoor","E07000092","Rural village",0,0,0,0,0,0,0,0,0,0,0,0
"2011","Rushmoor","E07000092","Rural village in a sparse setting",0,0,0,0,0,0,0,0,0,0,0,0
"2011","Rushmoor","E07000092","Rural hamlet and isolated dwellings",0,0,0,0,0,0,0,0,0,0,0,0
"2011","Rushmoor","E07000092","Rural hamlet and isolated dwellings in a sparse setting",0,0,0,0,0,0,0,0,0,0,0,0
"2011","Test Valley","E07000093","Total",47626,33501,16412,17089,311,6854,2115,4739,6128,4964,1164,832
"2011","Test Valley","E07000093","Urban (total)",30374,21353,9732,11621,196,4745,1548,3197,3760,3228,532,320
"2011","Test Valley","E07000093","Urban major conurbation",0,0,0,0,0,0,0,0,0,0,0,0
"2011","Test Valley","E07000093","Urban minor conurbation",0,0,0,0,0,0,0,0,0,0,0,0
"2011","Test Valley","E07000093","Urban city and town",30374,21353,9732,11621,196,4745,1548,3197,3760,3228,532,320
"2011","Test Valley","E07000093","Urban city and town in a sparse setting",0,0,0,0,0,0,0,0,0,0,0,0
"2011","Test Valley","E07000093","Rural (total)",17252,12148,6680,5468,115,2109,567,1542,2368,1736,632,512
"2011","Test Valley","E07000093","Rural town and fringe",4183,3215,1710,1505,19,498,140,358,414,290,124,37
"2011","Test Valley","E07000093","Rural town and fringe in a sparse setting",0,0,0,0,0,0,0,0,0,0,0,0
"2011","Test Valley","E07000093","Rural village",8678,5922,3172,2750,76,1315,365,950,1144,774,370,221
"2011","Test Valley","E07000093","Rural village in a sparse setting",0,0,0,0,0,0,0,0,0,0,0,0
"2011","Test Valley","E07000093","Rural hamlet and isolated dwellings",4391,3011,1798,1213,20,296,62,234,810,672,138,254
"2011","Test Valley","E07000093","Rural hamlet and isolated dwellings in a sparse setting",0,0,0,0,0,0,0,0,0,0,0,0
"2011","Winchester","E07000094","Total",46865,31646,16385,15261,426,7243,4970,2273,6604,5617,987,946
"2011","Winchester","E07000094","Urban (total)",19685,11568,5900,5668,161,4276,2850,1426,3348,2977,371,332
"2011","Winchester","E07000094","Urban major conurbation",0,0,0,0,0,0,0,0,0,0,0,0
"2011","Winchester","E07000094","Urban minor conurbation",0,0,0,0,0,0,0,0,0,0,0,0
"2011","Winchester","E07000094","Urban city and town",19685,11568,5900,5668,161,4276,2850,1426,3348,2977,371,332
"2011","Winchester","E07000094","Urban city and town in a sparse setting",0,0,0,0,0,0,0,0,0,0,0,0
"2011","Winchester","E07000094","Rural (total)",27180,20078,10485,9593,265,2967,2120,847,3256,2640,616,614
"2011","Winchester","E07000094","Rural town and fringe",15573,11636,5837,5799,183,1971,1389,582,1551,1288,263,232
"2011","Winchester","E07000094","Rural town and fringe in a sparse setting",0,0,0,0,0,0,0,0,0,0,0,0
"2011","Winchester","E07000094","Rural village",6749,4858,2607,2251,66,710,515,195,924,674,250,191
"2011","Winchester","E07000094","Rural village in a sparse setting",0,0,0,0,0,0,0,0,0,0,0,0
"2011","Winchester","E07000094","Rural hamlet and isolated dwellings",4858,3584,2041,1543,16,286,216,70,781,678,103,191
"2011","Winchester","E07000094","Rural hamlet and isolated dwellings in a sparse setting",0,0,0,0,0,0,0,0,0,0,0,0
"2011","Ashford","E07000105","Total",47787,32685,15200,17485,638,6915,4702,2213,6849,6173,676,700
"2011","Ashford","E07000105","Urban (total)",29552,18970,7270,11700,494,4744,3028,1716,4988,4540,448,356
"2011","Ashford","E07000105","Urban major conurbation",0,0,0,0,0,0,0,0,0,0,0,0
"2011","Ashford","E07000105","Urban minor conurbation",0,0,0,0,0,0,0,0,0,0,0,0
"2011","Ashford","E07000105","Urban city and town",29552,18970,7270,11700,494,4744,3028,1716,4988,4540,448,356
"2011","Ashford","E07000105","Urban city and town in a sparse setting",0,0,0,0,0,0,0,0,0,0,0,0
"2011","Ashford","E07000105","Rural (total)",18235,13715,7930,5785,144,2171,1674,497,1861,1633,228,344
"2011","Ashford","E07000105","Rural town and fringe",6437,4599,2722,1877,57,991,727,264,686,620,66,104
"2011","Ashford","E07000105","Rural town and fringe in a sparse setting",0,0,0,0,0,0,0,0,0,0,0,0
"2011","Ashford","E07000105","Rural village",6587,4826,2749,2077,60,975,792,183,610,524,86,116
"2011","Ashford","E07000105","Rural village in a sparse setting",0,0,0,0,0,0,0,0,0,0,0,0
"2011","Ashford","E07000105","Rural hamlet and isolated dwellings",5211,4290,2459,1831,27,205,155,50,565,489,76,124
"2011","Ashford","E07000105","Rural hamlet and isolated dwellings in a sparse setting",0,0,0,0,0,0,0,0,0,0,0,0
"2011","Canterbury","E07000106","Total",60771,40107,21578,18529,500,7409,5039,2370,11876,10665,1211,879
"2011","Canterbury","E07000106","Urban (total)",50478,32319,17558,14761,445,6471,4344,2127,10540,9494,1046,703
"2011","Canterbury","E07000106","Urban major conurbation",0,0,0,0,0,0,0,0,0,0,0,0
"2011","Canterbury","E07000106","Urban minor conurbation",0,0,0,0,0,0,0,0,0,0,0,0
"2011","Canterbury","E07000106","Urban city and town",50478,32319,17558,14761,445,6471,4344,2127,10540,9494,1046,703
"2011","Canterbury","E07000106","Urban city and town in a sparse setting",0,0,0,0,0,0,0,0,0,0,0,0
"2011","Canterbury","E07000106","Rural (total)",10293,7788,4020,3768,55,938,695,243,1336,1171,165,176
"2011","Canterbury","E07000106","Rural town and fringe",4497,3193,1486,1707,33,628,425,203,581,509,72,62
"2011","Canterbury","E07000106","Rural town and fringe in a sparse setting",0,0,0,0,0,0,0,0,0,0,0,0
"2011","Canterbury","E07000106","Rural village",3493,2779,1512,1267,10,205,172,33,433,375,58,66
"2011","Canterbury","E07000106","Rural village in a sparse setting",0,0,0,0,0,0,0,0,0,0,0,0
"2011","Canterbury","E07000106","Rural hamlet and isolated dwellings",2303,1816,1022,794,12,105,98,7,322,287,35,48
"2011","Canterbury","E07000106","Rural hamlet and isolated dwellings in a sparse setting",0,0,0,0,0,0,0,0,0,0,0,0
"2011","Dartford","E07000107","Total",40081,26819,11012,15807,537,5947,4338,1609,6385,6003,382,393
"2011","Dartford","E07000107","Urban (total)",35587,23593,9589,14004,468,5235,3768,1467,5950,5595,355,341
"2011","Dartford","E07000107","Urban major conurbation",33696,21922,8582,13340,463,5178,3719,1459,5810,5463,347,323
"2011","Dartford","E07000107","Urban minor conurbation",0,0,0,0,0,0,0,0,0,0,0,0
"2011","Dartford","E07000107","Urban city and town",1891,1671,1007,664,5,57,49,8,140,132,8,18
"2011","Dartford","E07000107","Urban city and town in a sparse setting",0,0,0,0,0,0,0,0,0,0,0,0
"2011","Dartford","E07000107","Rural (total)",4494,3226,1423,1803,69,712,570,142,435,408,27,52
"2011","Dartford","E07000107","Rural town and fringe",3421,2403,967,1436,59,638,499,139,286,266,20,35
"2011","Dartford","E07000107","Rural town and fringe in a sparse setting",0,0,0,0,0,0,0,0,0,0,0,0
"2011","Dartford","E07000107","Rural village",814,591,350,241,9,68,67,1,131,126,5,15
"2011","Dartford","E07000107","Rural village in a sparse setting",0,0,0,0,0,0,0,0,0,0,0,0
"2011","Dartford","E07000107","Rural hamlet and isolated dwellings",259,232,106,126,1,6,4,2,18,16,2,2
"2011","Dartford","E07000107","Rural hamlet and isolated dwellings in a sparse setting",0,0,0,0,0,0,0,0,0,0,0,0
"2011","Dover","E07000108","Total",48310,32142,17034,15108,245,6864,4277,2587,8254,7394,860,805
"2011","Dover","E07000108","Urban (total)",31788,20147,10312,9835,174,4822,2800,2022,6198,5688,510,447
"2011","Dover","E07000108","Urban major conurbation",0,0,0,0,0,0,0,0,0,0,0,0
"2011","Dover","E07000108","Urban minor conurbation",0,0,0,0,0,0,0,0,0,0,0,0
"2011","Dover","E07000108","Urban city and town",31788,20147,10312,9835,174,4822,2800,2022,6198,5688,510,447
"2011","Dover","E07000108","Urban city and town in a sparse setting",0,0,0,0,0,0,0,0,0,0,0,0
"2011","Dover","E07000108","Rural (total)",16522,11995,6722,5273,71,2042,1477,565,2056,1706,350,358
"2011","Dover","E07000108","Rural town and fringe",9032,6486,3686,2800,53,1360,972,388,973,865,108,160
"2011","Dover","E07000108","Rural town and fringe in a sparse setting",0,0,0,0,0,0,0,0,0,0,0,0
"2011","Dover","E07000108","Rural village",5674,4093,2214,1879,13,596,439,157,820,620,200,152
"2011","Dover","E07000108","Rural village in a sparse setting",0,0,0,0,0,0,0,0,0,0,0,0
"2011","Dover","E07000108","Rural hamlet and isolated dwellings",1816,1416,822,594,5,86,66,20,263,221,42,46
"2011","Dover","E07000108","Rural hamlet and isolated dwellings in a sparse setting",0,0,0,0,0,0,0,0,0,0,0,0
"2011","Gravesham","E07000109","Total",40431,26099,12408,13691,305,7008,5628,1380,6524,6108,416,495
"2011","Gravesham","E07000109","Urban (total)",32781,19549,8857,10692,283,6531,5247,1284,6002,5664,338,416
"2011","Gravesham","E07000109","Urban major conurbation",32660,19439,8803,10636,283,6531,5247,1284,5992,5654,338,415
"2011","Gravesham","E07000109","Urban minor conurbation",0,0,0,0,0,0,0,0,0,0,0,0
"2011","Gravesham","E07000109","Urban city and town",121,110,54,56,0,0,0,0,10,10,0,1
"2011","Gravesham","E07000109","Urban city and town in a sparse setting",0,0,0,0,0,0,0,0,0,0,0,0
"2011","Gravesham","E07000109","Rural (total)",7650,6550,3551,2999,22,477,381,96,522,444,78,79
"2011","Gravesham","E07000109","Rural town and fringe",4587,3989,2181,1808,17,255,218,37,284,241,43,42
"2011","Gravesham","E07000109","Rural town and fringe in a sparse setting",0,0,0,0,0,0,0,0,0,0,0,0
"2011","Gravesham","E07000109","Rural village",2033,1633,900,733,5,208,150,58,166,146,20,21
"2011","Gravesham","E07000109","Rural village in a sparse setting",0,0,0,0,0,0,0,0,0,0,0,0
"2011","Gravesham","E07000109","Rural hamlet and isolated dwellings",1030,928,470,458,0,14,13,1,72,57,15,16
"2011","Gravesham","E07000109","Rural hamlet and isolated dwellings in a sparse setting",0,0,0,0,0,0,0,0,0,0,0,0
"2011","Maidstone","E07000110","Total",63447,44700,20885,23815,671,8066,1495,6571,9256,8264,992,754
"2011","Maidstone","E07000110","Urban (total)",45604,30954,13829,17125,551,6510,1233,5277,7164,6427,737,425
"2011","Maidstone","E07000110","Urban major conurbation",0,0,0,0,0,0,0,0,0,0,0,0
"2011","Maidstone","E07000110","Urban minor conurbation",0,0,0,0,0,0,0,0,0,0,0,0
"2011","Maidstone","E07000110","Urban city and town",45604,30954,13829,17125,551,6510,1233,5277,7164,6427,737,425
"2011","Maidstone","E07000110","Urban city and town in a sparse setting",0,0,0,0,0,0,0,0,0,0,0,0
"2011","Maidstone","E07000110","Rural (total)",17843,13746,7056,6690,120,1556,262,1294,2092,1837,255,329
"2011","Maidstone","E07000110","Rural town and fringe",8501,6475,3219,3256,79,891,150,741,925,830,95,131
"2011","Maidstone","E07000110","Rural town and fringe in a sparse setting",0,0,0,0,0,0,0,0,0,0,0,0
"2011","Maidstone","E07000110","Rural village",4874,3762,2000,1762,27,489,80,409,503,425,78,93
"2011","Maidstone","E07000110","Rural village in a sparse setting",0,0,0,0,0,0,0,0,0,0,0,0
"2011","Maidstone","E07000110","Rural hamlet and isolated dwellings",4468,3509,1837,1672,14,176,32,144,664,582,82,105
"2011","Maidstone","E07000110","Rural hamlet and isolated dwellings in a sparse setting",0,0,0,0,0,0,0,0,0,0,0,0
"2011","Sevenoaks","E07000111","Total",47020,34200,17642,16558,798,6218,800,5418,5057,4547,510,747
"2011","Sevenoaks","E07000111","Urban (total)",25545,18169,9155,9014,446,3783,496,3287,2798,2546,252,349
"2011","Sevenoaks","E07000111","Urban major conurbation",8226,5605,2659,2946,151,1818,328,1490,547,491,56,105
"2011","Sevenoaks","E07000111","Urban minor conurbation",0,0,0,0,0,0,0,0,0,0,0,0
"2011","Sevenoaks","E07000111","Urban city and town",17319,12564,6496,6068,295,1965,168,1797,2251,2055,196,244
"2011","Sevenoaks","E07000111","Urban city and town in a sparse setting",0,0,0,0,0,0,0,0,0,0,0,0
"2011","Sevenoaks","E07000111","Rural (total)",21475,16031,8487,7544,352,2435,304,2131,2259,2001,258,398
"2011","Sevenoaks","E07000111","Rural town and fringe",10927,8090,4020,4070,274,1519,220,1299,923,832,91,121
"2011","Sevenoaks","E07000111","Rural town and fringe in a sparse setting",0,0,0,0,0,0,0,0,0,0,0,0
"2011","Sevenoaks","E07000111","Rural village",5527,4014,2211,1803,59,745,66,679,604,539,65,105
"2011","Sevenoaks","E07000111","Rural village in a sparse setting",0,0,0,0,0,0,0,0,0,0,0,0
"2011","Sevenoaks","E07000111","Rural hamlet and isolated dwellings",5021,3927,2256,1671,19,171,18,153,732,630,102,172
"2011","Sevenoaks","E07000111","Rural hamlet and isolated dwellings in a sparse setting",0,0,0,0,0,0,0,0,0,0,0,0
"2011","Shepway","E07000112","Total",47379,30715,16744,13971,214,5311,3284,2027,10520,9557,963,619
"2011","Shepway","E07000112","Urban (total)",30016,17274,9323,7951,126,3829,2330,1499,8435,7814,621,352
"2011","Shepway","E07000112","Urban major conurbation",0,0,0,0,0,0,0,0,0,0,0,0
"2011","Shepway","E07000112","Urban minor conurbation",0,0,0,0,0,0,0,0,0,0,0,0
"2011","Shepway","E07000112","Urban city and town",30016,17274,9323,7951,126,3829,2330,1499,8435,7814,621,352
"2011","Shepway","E07000112","Urban city and town in a sparse setting",0,0,0,0,0,0,0,0,0,0,0,0
"2011","Shepway","E07000112","Rural (total)",17363,13441,7421,6020,88,1482,954,528,2085,1743,342,267
"2011","Shepway","E07000112","Rural town and fringe",10631,7944,4239,3705,60,1162,715,447,1325,1088,237,140
"2011","Shepway","E07000112","Rural town and fringe in a sparse setting",0,0,0,0,0,0,0,0,0,0,0,0
"2011","Shepway","E07000112","Rural village",4507,3808,2265,1543,23,164,124,40,459,402,57,53
"2011","Shepway","E07000112","Rural village in a sparse setting",0,0,0,0,0,0,0,0,0,0,0,0
"2011","Shepway","E07000112","Rural hamlet and isolated dwellings",2225,1689,917,772,5,156,115,41,301,253,48,74
"2011","Shepway","E07000112","Rural hamlet and isolated dwellings in a sparse setting",0,0,0,0,0,0,0,0,0,0,0,0
"2011","Swale","E07000113","Total",55585,37951,17444,20507,569,7942,1216,6726,8446,7735,711,677
"2011","Swale","E07000113","Urban (total)",42808,28558,12795,15763,464,6535,1041,5494,6815,6294,521,436
"2011","Swale","E07000113","Urban major conurbation",0,0,0,0,0,0,0,0,0,0,0,0
"2011","Swale","E07000113","Urban minor conurbation",0,0,0,0,0,0,0,0,0,0,0,0
"2011","Swale","E07000113","Urban city and town",42808,28558,12795,15763,464,6535,1041,5494,6815,6294,521,436
"2011","Swale","E07000113","Urban city and town in a sparse setting",0,0,0,0,0,0,0,0,0,0,0,0
"2011","Swale","E07000113","Rural (total)",12777,9393,4649,4744,105,1407,175,1232,1631,1441,190,241
"2011","Swale","E07000113","Rural town and fringe",5256,3893,1672,2221,53,708,90,618,548,482,66,54
"2011","Swale","E07000113","Rural town and fringe in a sparse setting",0,0,0,0,0,0,0,0,0,0,0,0
"2011","Swale","E07000113","Rural village",3702,2725,1493,1232,33,371,41,330,507,462,45,66
"2011","Swale","E07000113","Rural village in a sparse setting",0,0,0,0,0,0,0,0,0,0,0,0
"2011","Swale","E07000113","Rural hamlet and isolated dwellings",3819,2775,1484,1291,19,328,44,284,576,497,79,121
"2011","Swale","E07000113","Rural hamlet and isolated dwellings in a sparse setting",0,0,0,0,0,0,0,0,0,0,0,0
"2011","Thanet","E07000114","Total",59513,36907,19903,17004,206,7537,3019,4518,14151,13072,1079,712
"2011","Thanet","E07000114","Urban (total)",55719,33986,18327,15659,191,7232,2935,4297,13661,12663,998,649
"2011","Thanet","E07000114","Urban major conurbation",0,0,0,0,0,0,0,0,0,0,0,0
"2011","Thanet","E07000114","Urban minor conurbation",0,0,0,0,0,0,0,0,0,0,0,0
"2011","Thanet","E07000114","Urban city and town",55719,33986,18327,15659,191,7232,2935,4297,13661,12663,998,649
"2011","Thanet","E07000114","Urban city and town in a sparse setting",0,0,0,0,0,0,0,0,0,0,0,0
"2011","Thanet","E07000114","Rural (total)",3794,2921,1576,1345,15,305,84,221,490,409,81,63
"2011","Thanet","E07000114","Rural town and fringe",1869,1459,762,697,6,182,64,118,200,174,26,22
"2011","Thanet","E07000114","Rural town and fringe in a sparse setting",0,0,0,0,0,0,0,0,0,0,0,0
"2011","Thanet","E07000114","Rural village",1615,1226,661,565,7,121,19,102,234,189,45,27
"2011","Thanet","E07000114","Rural village in a sparse setting",0,0,0,0,0,0,0,0,0,0,0,0
"2011","Thanet","E07000114","Rural hamlet and isolated dwellings",310,236,153,83,2,2,1,1,56,46,10,14
"2011","Thanet","E07000114","Rural hamlet and isolated dwellings in a sparse setting",0,0,0,0,0,0,0,0,0,0,0,0
"2011","Tonbridge and Malling","E07000115","Total",48140,34246,15677,18569,717,7762,930,6832,4869,4320,549,546
"2011","Tonbridge and Malling","E07000115","Urban (total)",31747,21906,10054,11852,514,5824,697,5127,3176,2803,373,327
"2011","Tonbridge and Malling","E07000115","Urban major conurbation",0,0,0,0,0,0,0,0,0,0,0,0
"2011","Tonbridge and Malling","E07000115","Urban minor conurbation",0,0,0,0,0,0,0,0,0,0,0,0
"2011","Tonbridge and Malling","E07000115","Urban city and town",31747,21906,10054,11852,514,5824,697,5127,3176,2803,373,327
"2011","Tonbridge and Malling","E07000115","Urban city and town in a sparse setting",0,0,0,0,0,0,0,0,0,0,0,0
"2011","Tonbridge and Malling","E07000115","Rural (total)",16393,12340,5623,6717,203,1938,233,1705,1693,1517,176,219
"2011","Tonbridge and Malling","E07000115","Rural town and fringe",9966,7255,3048,4207,168,1465,169,1296,980,893,87,98
"2011","Tonbridge and Malling","E07000115","Rural town and fringe in a sparse setting",0,0,0,0,0,0,0,0,0,0,0,0
"2011","Tonbridge and Malling","E07000115","Rural village",3914,3099,1576,1523,16,340,45,295,385,342,43,74
"2011","Tonbridge and Malling","E07000115","Rural village in a sparse setting",0,0,0,0,0,0,0,0,0,0,0,0
"2011","Tonbridge and Malling","E07000115","Rural hamlet and isolated dwellings",2513,1986,999,987,19,133,19,114,328,282,46,47
"2011","Tonbridge and Malling","E07000115","Rural hamlet and isolated dwellings in a sparse setting",0,0,0,0,0,0,0,0,0,0,0,0
"2011","Tunbridge Wells","E07000116","Total",47174,30999,15111,15888,376,7148,566,6582,7995,7412,583,656
"2011","Tunbridge Wells","E07000116","Urban (total)",29419,18331,8612,9719,268,4622,384,4238,5905,5562,343,293
"2011","Tunbridge Wells","E07000116","Urban major conurbation",0,0,0,0,0,0,0,0,0,0,0,0
"2011","Tunbridge Wells","E07000116","Urban minor conurbation",0,0,0,0,0,0,0,0,0,0,0,0
"2011","Tunbridge Wells","E07000116","Urban city and town",29419,18331,8612,9719,268,4622,384,4238,5905,5562,343,293
"2011","Tunbridge Wells","E07000116","Urban city and town in a sparse setting",0,0,0,0,0,0,0,0,0,0,0,0
"2011","Tunbridge Wells","E07000116","Rural (total)",17755,12668,6499,6169,108,2526,182,2344,2090,1850,240,363
"2011","Tunbridge Wells","E07000116","Rural town and fringe",9262,6465,3219,3246,74,1655,133,1522,948,859,89,120
"2011","Tunbridge Wells","E07000116","Rural town and fringe in a sparse setting",0,0,0,0,0,0,0,0,0,0,0,0
"2011","Tunbridge Wells","E07000116","Rural village",4920,3473,1794,1679,27,729,34,695,575,525,50,116
"2011","Tunbridge Wells","E07000116","Rural village in a sparse setting",0,0,0,0,0,0,0,0,0,0,0,0
"2011","Tunbridge Wells","E07000116","Rural hamlet and isolated dwellings",3573,2730,1486,1244,7,142,15,127,567,466,101,127
"2011","Tunbridge Wells","E07000116","Rural hamlet and isolated dwellings in a sparse setting",0,0,0,0,0,0,0,0,0,0,0,0
"2011","Cherwell","E07000177","Total",56728,39303,17512,21791,443,6872,1453,5419,9206,8304,902,904
"2011","Cherwell","E07000177","Urban (total)",39780,26539,10942,15597,310,5562,1227,4335,6852,6382,470,517
"2011","Cherwell","E07000177","Urban major conurbation",0,0,0,0,0,0,0,0,0,0,0,0
"2011","Cherwell","E07000177","Urban minor conurbation",0,0,0,0,0,0,0,0,0,0,0,0
"2011","Cherwell","E07000177","Urban city and town",39780,26539,10942,15597,310,5562,1227,4335,6852,6382,470,517
"2011","Cherwell","E07000177","Urban city and town in a sparse setting",0,0,0,0,0,0,0,0,0,0,0,0
"2011","Cherwell","E07000177","Rural (total)",16948,12764,6570,6194,133,1310,226,1084,2354,1922,432,387
"2011","Cherwell","E07000177","Rural town and fringe",4597,3448,1662,1786,37,411,48,363,625,387,238,76
"2011","Cherwell","E07000177","Rural town and fringe in a sparse setting",0,0,0,0,0,0,0,0,0,0,0,0
"2011","Cherwell","E07000177","Rural village",11227,8480,4445,4035,91,865,171,694,1536,1385,151,255
"2011","Cherwell","E07000177","Rural village in a sparse setting",0,0,0,0,0,0,0,0,0,0,0,0
"2011","Cherwell","E07000177","Rural hamlet and isolated dwellings",1124,836,463,373,5,34,7,27,193,150,43,56
"2011","Cherwell","E07000177","Rural hamlet and isolated dwellings in a sparse setting",0,0,0,0,0,0,0,0,0,0,0,0
"2011","Oxford","E07000178","Total",55375,25873,13277,12596,959,11828,7513,4315,15634,14458,1176,1081
"2011","Oxford","E07000178","Urban (total)",54596,25393,12996,12397,955,11737,7498,4239,15443,14283,1160,1068
"2011","Oxford","E07000178","Urban major conurbation",0,0,0,0,0,0,0,0,0,0,0,0
"2011","Oxford","E07000178","Urban minor conurbation",0,0,0,0,0,0,0,0,0,0,0,0
"2011","Oxford","E07000178","Urban city and town",54596,25393,12996,12397,955,11737,7498,4239,15443,14283,1160,1068
"2011","Oxford","E07000178","Urban city and town in a sparse setting",0,0,0,0,0,0,0,0,0,0,0,0
"2011","Oxford","E07000178","Rural (total)",779,480,281,199,4,91,15,76,191,175,16,13
"2011","Oxford","E07000178","Rural town and fringe",779,480,281,199,4,91,15,76,191,175,16,13
"2011","Oxford","E07000178","Rural town and fringe in a sparse setting",0,0,0,0,0,0,0,0,0,0,0,0
"2011","Oxford","E07000178","Rural village",0,0,0,0,0,0,0,0,0,0,0,0
"2011","Oxford","E07000178","Rural village in a sparse setting",0,0,0,0,0,0,0,0,0,0,0,0
"2011","Oxford","E07000178","Rural hamlet and isolated dwellings",0,0,0,0,0,0,0,0,0,0,0,0
"2011","Oxford","E07000178","Rural hamlet and isolated dwellings in a sparse setting",0,0,0,0,0,0,0,0,0,0,0,0
"2011","South Oxfordshire","E07000179","Total",54104,39461,20113,19348,459,6163,854,5309,7211,5999,1212,810
"2011","South Oxfordshire","E07000179","Urban (total)",28063,19931,9445,10486,286,3565,495,3070,4017,3642,375,264
"2011","South Oxfordshire","E07000179","Urban major conurbation",0,0,0,0,0,0,0,0,0,0,0,0
"2011","South Oxfordshire","E07000179","Urban minor conurbation",0,0,0,0,0,0,0,0,0,0,0,0
"2011","South Oxfordshire","E07000179","Urban city and town",28063,19931,9445,10486,286,3565,495,3070,4017,3642,375,264
"2011","South Oxfordshire","E07000179","Urban city and town in a sparse setting",0,0,0,0,0,0,0,0,0,0,0,0
"2011","South Oxfordshire","E07000179","Rural (total)",26041,19530,10668,8862,173,2598,359,2239,3194,2357,837,546
"2011","South Oxfordshire","E07000179","Rural town and fringe",13287,10011,5326,4685,94,1564,236,1328,1473,915,558,145
"2011","South Oxfordshire","E07000179","Rural town and fringe in a sparse setting",0,0,0,0,0,0,0,0,0,0,0,0
"2011","South Oxfordshire","E07000179","Rural village",8942,6860,3829,3031,52,817,96,721,979,831,148,234
"2011","South Oxfordshire","E07000179","Rural village in a sparse setting",0,0,0,0,0,0,0,0,0,0,0,0
"2011","South Oxfordshire","E07000179","Rural hamlet and isolated dwellings",3812,2659,1513,1146,27,217,27,190,742,611,131,167
"2011","South Oxfordshire","E07000179","Rural hamlet and isolated dwellings in a sparse setting",0,0,0,0,0,0,0,0,0,0,0,0
"2011","Vale of White Horse","E07000180","Total",49407,34750,17704,17046,514,6583,1230,5353,6733,5423,1310,827
"2011","Vale of White Horse","E07000180","Urban (total)",30508,21548,10738,10810,376,4185,833,3352,4091,3409,682,308
"2011","Vale of White Horse","E07000180","Urban major conurbation",0,0,0,0,0,0,0,0,0,0,0,0
"2011","Vale of White Horse","E07000180","Urban minor conurbation",0,0,0,0,0,0,0,0,0,0,0,0
"2011","Vale of White Horse","E07000180","Urban city and town",30508,21548,10738,10810,376,4185,833,3352,4091,3409,682,308
"2011","Vale of White Horse","E07000180","Urban city and town in a sparse setting",0,0,0,0,0,0,0,0,0,0,0,0
"2011","Vale of White Horse","E07000180","Rural (total)",18899,13202,6966,6236,138,2398,397,2001,2642,2014,628,519
"2011","Vale of White Horse","E07000180","Rural town and fringe",10065,7080,3651,3429,104,1484,263,1221,1220,920,300,177
"2011","Vale of White Horse","E07000180","Rural town and fringe in a sparse setting",0,0,0,0,0,0,0,0,0,0,0,0
"2011","Vale of White Horse","E07000180","Rural village",7010,4862,2630,2232,31,845,124,721,1076,844,232,196
"2011","Vale of White Horse","E07000180","Rural village in a sparse setting",0,0,0,0,0,0,0,0,0,0,0,0
"2011","Vale of White Horse","E07000180","Rural hamlet and isolated dwellings",1824,1260,685,575,3,69,10,59,346,250,96,146
"2011","Vale of White Horse","E07000180","Rural hamlet and isolated dwellings in a sparse setting",0,0,0,0,0,0,0,0,0,0,0,0
"2011","West Oxfordshire","E07000181","Total",43241,30141,14915,15226,548,5387,738,4649,6423,5108,1315,742
"2011","West Oxfordshire","E07000181","Urban (total)",18191,11847,4880,6967,386,2533,256,2277,3272,2335,937,153
"2011","West Oxfordshire","E07000181","Urban major conurbation",0,0,0,0,0,0,0,0,0,0,0,0
"2011","West Oxfordshire","E07000181","Urban minor conurbation",0,0,0,0,0,0,0,0,0,0,0,0
"2011","West Oxfordshire","E07000181","Urban city and town",18191,11847,4880,6967,386,2533,256,2277,3272,2335,937,153
"2011","West Oxfordshire","E07000181","Urban city and town in a sparse setting",0,0,0,0,0,0,0,0,0,0,0,0
"2011","West Oxfordshire","E07000181","Rural (total)",25050,18294,10035,8259,162,2854,482,2372,3151,2773,378,589
"2011","West Oxfordshire","E07000181","Rural town and fringe",12631,9201,5016,4185,90,1728,302,1426,1454,1277,177,158
"2011","West Oxfordshire","E07000181","Rural town and fringe in a sparse setting",0,0,0,0,0,0,0,0,0,0,0,0
"2011","West Oxfordshire","E07000181","Rural village",9586,7221,3888,3333,50,969,162,807,1095,966,129,251
"2011","West Oxfordshire","E07000181","Rural village in a sparse setting",0,0,0,0,0,0,0,0,0,0,0,0
"2011","West Oxfordshire","E07000181","Rural hamlet and isolated dwellings",2833,1872,1131,741,22,157,18,139,602,530,72,180
"2011","West Oxfordshire","E07000181","Rural hamlet and isolated dwellings in a sparse setting",0,0,0,0,0,0,0,0,0,0,0,0
"2011","Elmbridge","E07000207","Total",52922,38660,18119,20541,393,5218,1124,4094,8006,7478,528,645
"2011","Elmbridge","E07000207","Urban (total)",51835,37975,17790,20185,383,5029,1079,3950,7830,7328,502,618
"2011","Elmbridge","E07000207","Urban major conurbation",44364,32687,14981,17706,325,4080,889,3191,6787,6382,405,485
"2011","Elmbridge","E07000207","Urban minor conurbation",0,0,0,0,0,0,0,0,0,0,0,0
"2011","Elmbridge","E07000207","Urban city and town",7471,5288,2809,2479,58,949,190,759,1043,946,97,133
"2011","Elmbridge","E07000207","Urban city and town in a sparse setting",0,0,0,0,0,0,0,0,0,0,0,0
"2011","Elmbridge","E07000207","Rural (total)",1087,685,329,356,10,189,45,144,176,150,26,27
"2011","Elmbridge","E07000207","Rural town and fringe",563,339,146,193,10,150,41,109,55,49,6,9
"2011","Elmbridge","E07000207","Rural town and fringe in a sparse setting",0,0,0,0,0,0,0,0,0,0,0,0
"2011","Elmbridge","E07000207","Rural village",121,80,46,34,0,16,3,13,22,20,2,3
"2011","Elmbridge","E07000207","Rural village in a sparse setting",0,0,0,0,0,0,0,0,0,0,0,0
"2011","Elmbridge","E07000207","Rural hamlet and isolated dwellings",403,266,137,129,0,23,1,22,99,81,18,15
"2011","Elmbridge","E07000207","Rural hamlet and isolated dwellings in a sparse setting",0,0,0,0,0,0,0,0,0,0,0,0
"2011","Epsom and Ewell","E07000208","Total",29784,22931,10969,11962,257,2390,166,2224,3962,3628,334,244
"2011","Epsom and Ewell","E07000208","Urban (total)",28704,22010,10559,11451,251,2340,165,2175,3872,3548,324,231
"2011","Epsom and Ewell","E07000208","Urban major conurbation",28704,22010,10559,11451,251,2340,165,2175,3872,3548,324,231
"2011","Epsom and Ewell","E07000208","Urban minor conurbation",0,0,0,0,0,0,0,0,0,0,0,0
"2011","Epsom and Ewell","E07000208","Urban city and town",0,0,0,0,0,0,0,0,0,0,0,0
"2011","Epsom and Ewell","E07000208","Urban city and town in a sparse setting",0,0,0,0,0,0,0,0,0,0,0,0
"2011","Epsom and Ewell","E07000208","Rural (total)",1080,921,410,511,6,50,1,49,90,80,10,13
"2011","Epsom and Ewell","E07000208","Rural town and fringe",1080,921,410,511,6,50,1,49,90,80,10,13
"2011","Epsom and Ewell","E07000208","Rural town and fringe in a sparse setting",0,0,0,0,0,0,0,0,0,0,0,0
"2011","Epsom and Ewell","E07000208","Rural village",0,0,0,0,0,0,0,0,0,0,0,0
"2011","Epsom and Ewell","E07000208","Rural village in a sparse setting",0,0,0,0,0,0,0,0,0,0,0,0
"2011","Epsom and Ewell","E07000208","Rural hamlet and isolated dwellings",0,0,0,0,0,0,0,0,0,0,0,0
"2011","Epsom and Ewell","E07000208","Rural hamlet and isolated dwellings in a sparse setting",0,0,0,0,0,0,0,0,0,0,0,0
"2011","Guildford","E07000209","Total",53973,37148,18204,18944,702,6908,4928,1980,8522,7426,1096,693
"2011","Guildford","E07000209","Urban (total)",40372,26486,12191,14295,584,5636,3986,1650,7210,6334,876,456
"2011","Guildford","E07000209","Urban major conurbation",0,0,0,0,0,0,0,0,0,0,0,0
"2011","Guildford","E07000209","Urban minor conurbation",0,0,0,0,0,0,0,0,0,0,0,0
"2011","Guildford","E07000209","Urban city and town",40372,26486,12191,14295,584,5636,3986,1650,7210,6334,876,456
"2011","Guildford","E07000209","Urban city and town in a sparse setting",0,0,0,0,0,0,0,0,0,0,0,0
"2011","Guildford","E07000209","Rural (total)",13601,10662,6013,4649,118,1272,942,330,1312,1092,220,237
"2011","Guildford","E07000209","Rural town and fringe",3905,2938,1616,1322,64,599,461,138,259,224,35,45
"2011","Guildford","E07000209","Rural town and fringe in a sparse setting",0,0,0,0,0,0,0,0,0,0,0,0
"2011","Guildford","E07000209","Rural village",6642,5227,2970,2257,41,581,418,163,676,555,121,117
"2011","Guildford","E07000209","Rural village in a sparse setting",0,0,0,0,0,0,0,0,0,0,0,0
"2011","Guildford","E07000209","Rural hamlet and isolated dwellings",3054,2497,1427,1070,13,92,63,29,377,313,64,75
"2011","Guildford","E07000209","Rural hamlet and isolated dwellings in a sparse setting",0,0,0,0,0,0,0,0,0,0,0,0
"2011","Mole Valley","E07000210","Total",35828,26362,14011,12351,331,4373,531,3842,4270,3795,475,492
"2011","Mole Valley","E07000210","Urban (total)",26698,19624,10294,9330,257,3401,419,2982,3137,2830,307,279
"2011","Mole Valley","E07000210","Urban major conurbation",18181,13869,7521,6348,137,2078,269,1809,1918,1727,191,179
"2011","Mole Valley","E07000210","Urban minor conurbation",0,0,0,0,0,0,0,0,0,0,0,0
"2011","Mole Valley","E07000210","Urban city and town",8517,5755,2773,2982,120,1323,150,1173,1219,1103,116,100
"2011","Mole Valley","E07000210","Urban city and town in a sparse setting",0,0,0,0,0,0,0,0,0,0,0,0
"2011","Mole Valley","E07000210","Rural (total)",9130,6738,3717,3021,74,972,112,860,1133,965,168,213
"2011","Mole Valley","E07000210","Rural town and fringe",2362,1767,1014,753,26,336,41,295,207,180,27,26
"2011","Mole Valley","E07000210","Rural town and fringe in a sparse setting",0,0,0,0,0,0,0,0,0,0,0,0
"2011","Mole Valley","E07000210","Rural village",3307,2385,1263,1122,29,466,54,412,370,294,76,57
"2011","Mole Valley","E07000210","Rural village in a sparse setting",0,0,0,0,0,0,0,0,0,0,0,0
"2011","Mole Valley","E07000210","Rural hamlet and isolated dwellings",3461,2586,1440,1146,19,170,17,153,556,491,65,130
"2011","Mole Valley","E07000210","Rural hamlet and isolated dwellings in a sparse setting",0,0,0,0,0,0,0,0,0,0,0,0
"2011","Reigate and Banstead","E07000211","Total",55423,40486,18393,22093,673,6605,1345,5260,7169,6653,516,490
"2011","Reigate and Banstead","E07000211","Urban (total)",52726,38358,17435,20923,643,6449,1318,5131,6848,6360,488,428
"2011","Reigate and Banstead","E07000211","Urban major conurbation",14974,12081,5927,6154,153,1580,291,1289,1051,951,100,109
"2011","Reigate and Banstead","E07000211","Urban minor conurbation",0,0,0,0,0,0,0,0,0,0,0,0
"2011","Reigate and Banstead","E07000211","Urban city and town",37752,26277,11508,14769,490,4869,1027,3842,5797,5409,388,319
"2011","Reigate and Banstead","E07000211","Urban city and town in a sparse setting",0,0,0,0,0,0,0,0,0,0,0,0
"2011","Reigate and Banstead","E07000211","Rural (total)",2697,2128,958,1170,30,156,27,129,321,293,28,62
"2011","Reigate and Banstead","E07000211","Rural town and fringe",1011,738,280,458,16,63,5,58,166,155,11,28
"2011","Reigate and Banstead","E07000211","Rural town and fringe in a sparse setting",0,0,0,0,0,0,0,0,0,0,0,0
"2011","Reigate and Banstead","E07000211","Rural village",671,532,221,311,12,52,12,40,66,61,5,9
"2011","Reigate and Banstead","E07000211","Rural village in a sparse setting",0,0,0,0,0,0,0,0,0,0,0,0
"2011","Reigate and Banstead","E07000211","Rural hamlet and isolated dwellings",1015,858,457,401,2,41,10,31,89,77,12,25
"2011","Reigate and Banstead","E07000211","Rural hamlet and isolated dwellings in a sparse setting",0,0,0,0,0,0,0,0,0,0,0,0
"2011","Runnymede","E07000212","Total",32714,22731,10827,11904,326,4210,2897,1313,4974,4492,482,473
"2011","Runnymede","E07000212","Urban (total)",32075,22262,10534,11728,323,4191,2887,1304,4851,4431,420,448
"2011","Runnymede","E07000212","Urban major conurbation",27794,19036,8642,10394,277,3904,2797,1107,4257,3920,337,320
"2011","Runnymede","E07000212","Urban minor conurbation",0,0,0,0,0,0,0,0,0,0,0,0
"2011","Runnymede","E07000212","Urban city and town",4281,3226,1892,1334,46,287,90,197,594,511,83,128
"2011","Runnymede","E07000212","Urban city and town in a sparse setting",0,0,0,0,0,0,0,0,0,0,0,0
"2011","Runnymede","E07000212","Rural (total)",639,469,293,176,3,19,10,9,123,61,62,25
"2011","Runnymede","E07000212","Rural town and fringe",69,26,19,7,0,3,1,2,31,16,15,9
"2011","Runnymede","E07000212","Rural town and fringe in a sparse setting",0,0,0,0,0,0,0,0,0,0,0,0
"2011","Runnymede","E07000212","Rural village",118,68,35,33,2,2,0,2,44,4,40,2
"2011","Runnymede","E07000212","Rural village in a sparse setting",0,0,0,0,0,0,0,0,0,0,0,0
"2011","Runnymede","E07000212","Rural hamlet and isolated dwellings",452,375,239,136,1,14,9,5,48,41,7,14
"2011","Runnymede","E07000212","Rural hamlet and isolated dwellings in a sparse setting",0,0,0,0,0,0,0,0,0,0,0,0
"2011","Spelthorne","E07000213","Total",39512,28671,13403,15268,540,4911,636,4275,5004,4633,371,386
"2011","Spelthorne","E07000213","Urban (total)",38930,28169,13122,15047,534,4889,634,4255,4964,4593,371,374
"2011","Spelthorne","E07000213","Urban major conurbation",37718,27253,12725,14528,523,4773,626,4147,4801,4445,356,368
"2011","Spelthorne","E07000213","Urban minor conurbation",0,0,0,0,0,0,0,0,0,0,0,0
"2011","Spelthorne","E07000213","Urban city and town",1212,916,397,519,11,116,8,108,163,148,15,6
"2011","Spelthorne","E07000213","Urban city and town in a sparse setting",0,0,0,0,0,0,0,0,0,0,0,0
"2011","Spelthorne","E07000213","Rural (total)",582,502,281,221,6,22,2,20,40,40,0,12
"2011","Spelthorne","E07000213","Rural town and fringe",319,273,167,106,4,16,2,14,20,20,0,6
"2011","Spelthorne","E07000213","Rural town and fringe in a sparse setting",0,0,0,0,0,0,0,0,0,0,0,0
"2011","Spelthorne","E07000213","Rural village",0,0,0,0,0,0,0,0,0,0,0,0
"2011","Spelthorne","E07000213","Rural village in a sparse setting",0,0,0,0,0,0,0,0,0,0,0,0
"2011","Spelthorne","E07000213","Rural hamlet and isolated dwellings",263,229,114,115,2,6,0,6,20,20,0,6
"2011","Spelthorne","E07000213","Rural hamlet and isolated dwellings in a sparse setting",0,0,0,0,0,0,0,0,0,0,0,0
"2011","Surrey Heath","E07000214","Total",33546,25769,11668,14101,269,3089,394,2695,4073,3420,653,346
"2011","Surrey Heath","E07000214","Urban (total)",27939,21257,9635,11622,259,2698,348,2350,3434,2876,558,291
"2011","Surrey Heath","E07000214","Urban major conurbation",1100,976,392,584,6,23,2,21,89,84,5,6
"2011","Surrey Heath","E07000214","Urban minor conurbation",0,0,0,0,0,0,0,0,0,0,0,0
"2011","Surrey Heath","E07000214","Urban city and town",26839,20281,9243,11038,253,2675,346,2329,3345,2792,553,285
"2011","Surrey Heath","E07000214","Urban city and town in a sparse setting",0,0,0,0,0,0,0,0,0,0,0,0
"2011","Surrey Heath","E07000214","Rural (total)",5607,4512,2033,2479,10,391,46,345,639,544,95,55
"2011","Surrey Heath","E07000214","Rural town and fringe",4938,3994,1776,2218,9,381,43,338,518,487,31,36
"2011","Surrey Heath","E07000214","Rural town and fringe in a sparse setting",0,0,0,0,0,0,0,0,0,0,0,0
"2011","Surrey Heath","E07000214","Rural village",249,222,104,118,0,0,0,0,22,19,3,5
"2011","Surrey Heath","E07000214","Rural village in a sparse setting",0,0,0,0,0,0,0,0,0,0,0,0
"2011","Surrey Heath","E07000214","Rural hamlet and isolated dwellings",420,296,153,143,1,10,3,7,99,38,61,14
"2011","Surrey Heath","E07000214","Rural hamlet and isolated dwellings in a sparse setting",0,0,0,0,0,0,0,0,0,0,0,0
"2011","Tandridge","E07000215","Total",33342,25302,12074,13228,313,3610,2567,1043,3666,3236,430,451
"2011","Tandridge","E07000215","Urban (total)",21220,16221,7628,8593,246,2171,1465,706,2363,2156,207,219
"2011","Tandridge","E07000215","Urban major conurbation",13311,10094,4518,5576,207,1252,794,458,1634,1498,136,124
"2011","Tandridge","E07000215","Urban minor conurbation",0,0,0,0,0,0,0,0,0,0,0,0
"2011","Tandridge","E07000215","Urban city and town",7909,6127,3110,3017,39,919,671,248,729,658,71,95
"2011","Tandridge","E07000215","Urban city and town in a sparse setting",0,0,0,0,0,0,0,0,0,0,0,0
"2011","Tandridge","E07000215","Rural (total)",12122,9081,4446,4635,67,1439,1102,337,1303,1080,223,232
"2011","Tandridge","E07000215","Rural town and fringe",6536,4796,2271,2525,37,1001,775,226,607,524,83,95
"2011","Tandridge","E07000215","Rural town and fringe in a sparse setting",0,0,0,0,0,0,0,0,0,0,0,0
"2011","Tandridge","E07000215","Rural village",3687,2890,1463,1427,21,351,294,57,349,308,41,76
"2011","Tandridge","E07000215","Rural village in a sparse setting",0,0,0,0,0,0,0,0,0,0,0,0
"2011","Tandridge","E07000215","Rural hamlet and isolated dwellings",1899,1395,712,683,9,87,33,54,347,248,99,61
"2011","Tandridge","E07000215","Rural hamlet and isolated dwellings in a sparse setting",0,0,0,0,0,0,0,0,0,0,0,0
"2011","Waverley","E07000216","Total",49280,36295,18572,17723,491,6068,4662,1406,5577,4966,611,849
"2011","Waverley","E07000216","Urban (total)",36023,26227,13191,13036,351,4653,3530,1123,4305,3893,412,487
"2011","Waverley","E07000216","Urban major conurbation",0,0,0,0,0,0,0,0,0,0,0,0
"2011","Waverley","E07000216","Urban minor conurbation",0,0,0,0,0,0,0,0,0,0,0,0
"2011","Waverley","E07000216","Urban city and town",36023,26227,13191,13036,351,4653,3530,1123,4305,3893,412,487
"2011","Waverley","E07000216","Urban city and town in a sparse setting",0,0,0,0,0,0,0,0,0,0,0,0
"2011","Waverley","E07000216","Rural (total)",13257,10068,5381,4687,140,1415,1132,283,1272,1073,199,362
"2011","Waverley","E07000216","Rural town and fringe",5643,4151,2106,2045,78,824,680,144,498,451,47,92
"2011","Waverley","E07000216","Rural town and fringe in a sparse setting",0,0,0,0,0,0,0,0,0,0,0,0
"2011","Waverley","E07000216","Rural village",4095,3187,1772,1415,49,437,366,71,312,263,49,110
"2011","Waverley","E07000216","Rural village in a sparse setting",0,0,0,0,0,0,0,0,0,0,0,0
"2011","Waverley","E07000216","Rural hamlet and isolated dwellings",3519,2730,1503,1227,13,154,86,68,462,359,103,160
"2011","Waverley","E07000216","Rural hamlet and isolated dwellings in a sparse setting",0,0,0,0,0,0,0,0,0,0,0,0
"2011","Woking","E07000217","Total",39467,27829,12479,15350,368,4704,3308,1396,6186,5745,441,380
"2011","Woking","E07000217","Urban (total)",38707,27157,12107,15050,363,4689,3302,1387,6134,5695,439,364
"2011","Woking","E07000217","Urban major conurbation",37289,25933,11464,14469,355,4663,3287,1376,5991,5568,423,347
"2011","Woking","E07000217","Urban minor conurbation",0,0,0,0,0,0,0,0,0,0,0,0
"2011","Woking","E07000217","Urban city and town",1418,1224,643,581,8,26,15,11,143,127,16,17
"2011","Woking","E07000217","Urban city and town in a sparse setting",0,0,0,0,0,0,0,0,0,0,0,0
"2011","Woking","E07000217","Rural (total)",760,672,372,300,5,15,6,9,52,50,2,16
"2011","Woking","E07000217","Rural town and fringe",125,112,63,49,0,1,1,0,12,11,1,0
"2011","Woking","E07000217","Rural town and fringe in a sparse setting",0,0,0,0,0,0,0,0,0,0,0,0
"2011","Woking","E07000217","Rural village",243,210,137,73,4,7,0,7,18,17,1,4
"2011","Woking","E07000217","Rural village in a sparse setting",0,0,0,0,0,0,0,0,0,0,0,0
"2011","Woking","E07000217","Rural hamlet and isolated dwellings",392,350,172,178,1,7,5,2,22,22,0,12
"2011","Woking","E07000217","Rural hamlet and isolated dwellings in a sparse setting",0,0,0,0,0,0,0,0,0,0,0,0
"2011","Adur","E07000223","Total",26957,19883,10191,9692,154,3523,2652,871,3079,2762,317,318
"2011","Adur","E07000223","Urban (total)",26733,19749,10132,9617,153,3519,2651,868,3033,2728,305,279
"2011","Adur","E07000223","Urban major conurbation",0,0,0,0,0,0,0,0,0,0,0,0
"2011","Adur","E07000223","Urban minor conurbation",0,0,0,0,0,0,0,0,0,0,0,0
"2011","Adur","E07000223","Urban city and town",26733,19749,10132,9617,153,3519,2651,868,3033,2728,305,279
"2011","Adur","E07000223","Urban city and town in a sparse setting",0,0,0,0,0,0,0,0,0,0,0,0
"2011","Adur","E07000223","Rural (total)",224,134,59,75,1,4,1,3,46,34,12,39
"2011","Adur","E07000223","Rural town and fringe",0,0,0,0,0,0,0,0,0,0,0,0
"2011","Adur","E07000223","Rural town and fringe in a sparse setting",0,0,0,0,0,0,0,0,0,0,0,0
"2011","Adur","E07000223","Rural village",0,0,0,0,0,0,0,0,0,0,0,0
"2011","Adur","E07000223","Rural village in a sparse setting",0,0,0,0,0,0,0,0,0,0,0,0
"2011","Adur","E07000223","Rural hamlet and isolated dwellings",224,134,59,75,1,4,1,3,46,34,12,39
"2011","Adur","E07000223","Rural hamlet and isolated dwellings in a sparse setting",0,0,0,0,0,0,0,0,0,0,0,0
"2011","Arun","E07000224","Total",66706,49254,28581,20673,566,5886,3225,2661,10211,9427,784,789
"2011","Arun","E07000224","Urban (total)",56004,40987,24074,16913,494,4953,2601,2352,8984,8357,627,586
"2011","Arun","E07000224","Urban major conurbation",0,0,0,0,0,0,0,0,0,0,0,0
"2011","Arun","E07000224","Urban minor conurbation",0,0,0,0,0,0,0,0,0,0,0,0
"2011","Arun","E07000224","Urban city and town",56004,40987,24074,16913,494,4953,2601,2352,8984,8357,627,586
"2011","Arun","E07000224","Urban city and town in a sparse setting",0,0,0,0,0,0,0,0,0,0,0,0
"2011","Arun","E07000224","Rural (total)",10702,8267,4507,3760,72,933,624,309,1227,1070,157,203
"2011","Arun","E07000224","Rural town and fringe",7214,5532,2884,2648,41,765,512,253,764,669,95,112
"2011","Arun","E07000224","Rural town and fringe in a sparse setting",0,0,0,0,0,0,0,0,0,0,0,0
"2011","Arun","E07000224","Rural village",1988,1574,914,660,26,128,77,51,210,176,34,50
"2011","Arun","E07000224","Rural village in a sparse setting",0,0,0,0,0,0,0,0,0,0,0,0
"2011","Arun","E07000224","Rural hamlet and isolated dwellings",1500,1161,709,452,5,40,35,5,253,225,28,41
"2011","Arun","E07000224","Rural hamlet and isolated dwellings in a sparse setting",0,0,0,0,0,0,0,0,0,0,0,0
"2011","Chichester","E07000225","Total",49848,33481,20210,13271,455,7407,1084,6323,7423,6356,1067,1082
"2011","Chichester","E07000225","Urban (total)",23990,15860,9578,6282,219,3837,547,3290,3732,3291,441,342
"2011","Chichester","E07000225","Urban major conurbation",0,0,0,0,0,0,0,0,0,0,0,0
"2011","Chichester","E07000225","Urban minor conurbation",0,0,0,0,0,0,0,0,0,0,0,0
"2011","Chichester","E07000225","Urban city and town",23990,15860,9578,6282,219,3837,547,3290,3732,3291,441,342
"2011","Chichester","E07000225","Urban city and town in a sparse setting",0,0,0,0,0,0,0,0,0,0,0,0
"2011","Chichester","E07000225","Rural (total)",25858,17621,10632,6989,236,3570,537,3033,3691,3065,626,740
"2011","Chichester","E07000225","Rural town and fringe",11770,7735,4648,3087,165,2104,304,1800,1548,1383,165,218
"2011","Chichester","E07000225","Rural town and fringe in a sparse setting",0,0,0,0,0,0,0,0,0,0,0,0
"2011","Chichester","E07000225","Rural village",8719,6131,3656,2475,52,1143,166,977,1154,846,308,239
"2011","Chichester","E07000225","Rural village in a sparse setting",0,0,0,0,0,0,0,0,0,0,0,0
"2011","Chichester","E07000225","Rural hamlet and isolated dwellings",5369,3755,2328,1427,19,323,67,256,989,836,153,283
"2011","Chichester","E07000225","Rural hamlet and isolated dwellings in a sparse setting",0,0,0,0,0,0,0,0,0,0,0,0
"2011","Crawley","E07000226","Total",42727,25228,9480,15748,588,10194,7954,2240,6214,5789,425,503
"2011","Crawley","E07000226","Urban (total)",42601,25118,9436,15682,588,10186,7949,2237,6208,5784,424,501
"2011","Crawley","E07000226","Urban major conurbation",0,0,0,0,0,0,0,0,0,0,0,0
"2011","Crawley","E07000226","Urban minor conurbation",0,0,0,0,0,0,0,0,0,0,0,0
"2011","Crawley","E07000226","Urban city and town",42601,25118,9436,15682,588,10186,7949,2237,6208,5784,424,501
"2011","Crawley","E07000226","Urban city and town in a sparse setting",0,0,0,0,0,0,0,0,0,0,0,0
"2011","Crawley","E07000226","Rural (total)",126,110,44,66,0,8,5,3,6,5,1,2
"2011","Crawley","E07000226","Rural town and fringe",126,110,44,66,0,8,5,3,6,5,1,2
"2011","Crawley","E07000226","Rural town and fringe in a sparse setting",0,0,0,0,0,0,0,0,0,0,0,0
"2011","Crawley","E07000226","Rural village",0,0,0,0,0,0,0,0,0,0,0,0
"2011","Crawley","E07000226","Rural village in a sparse setting",0,0,0,0,0,0,0,0,0,0,0,0
"2011","Crawley","E07000226","Rural hamlet and isolated dwellings",0,0,0,0,0,0,0,0,0,0,0,0
"2011","Crawley","E07000226","Rural hamlet and isolated dwellings in a sparse setting",0,0,0,0,0,0,0,0,0,0,0,0
"2011","Horsham","E07000227","Total",54923,40926,20486,20440,363,6347,672,5675,6480,5772,708,807
"2011","Horsham","E07000227","Urban (total)",22115,15809,7390,8419,145,2987,278,2709,2972,2758,214,202
"2011","Horsham","E07000227","Urban major conurbation",0,0,0,0,0,0,0,0,0,0,0,0
"2011","Horsham","E07000227","Urban minor conurbation",0,0,0,0,0,0,0,0,0,0,0,0
"2011","Horsham","E07000227","Urban city and town",22115,15809,7390,8419,145,2987,278,2709,2972,2758,214,202
"2011","Horsham","E07000227","Urban city and town in a sparse setting",0,0,0,0,0,0,0,0,0,0,0,0
"2011","Horsham","E07000227","Rural (total)",32808,25117,13096,12021,218,3360,394,2966,3508,3014,494,605
"2011","Horsham","E07000227","Rural town and fringe",22462,17134,8754,8380,180,2780,331,2449,2125,1886,239,243
"2011","Horsham","E07000227","Rural town and fringe in a sparse setting",0,0,0,0,0,0,0,0,0,0,0,0
"2011","Horsham","E07000227","Rural village",4498,3448,1799,1649,19,379,40,339,513,406,107,139
"2011","Horsham","E07000227","Rural village in a sparse setting",0,0,0,0,0,0,0,0,0,0,0,0
"2011","Horsham","E07000227","Rural hamlet and isolated dwellings",5848,4535,2543,1992,19,201,23,178,870,722,148,223
"2011","Horsham","E07000227","Rural hamlet and isolated dwellings in a sparse setting",0,0,0,0,0,0,0,0,0,0,0,0
"2011","Mid Sussex","E07000228","Total",57409,42658,20408,22250,561,6092,295,5797,7322,6719,603,776
"2011","Mid Sussex","E07000228","Urban (total)",47677,35680,16757,18923,494,5087,260,4827,5993,5594,399,423
"2011","Mid Sussex","E07000228","Urban major conurbation",0,0,0,0,0,0,0,0,0,0,0,0
"2011","Mid Sussex","E07000228","Urban minor conurbation",0,0,0,0,0,0,0,0,0,0,0,0
"2011","Mid Sussex","E07000228","Urban city and town",47677,35680,16757,18923,494,5087,260,4827,5993,5594,399,423
"2011","Mid Sussex","E07000228","Urban city and town in a sparse setting",0,0,0,0,0,0,0,0,0,0,0,0
"2011","Mid Sussex","E07000228","Rural (total)",9732,6978,3651,3327,67,1005,35,970,1329,1125,204,353
"2011","Mid Sussex","E07000228","Rural town and fringe",2543,1771,935,836,15,456,11,445,256,224,32,45
"2011","Mid Sussex","E07000228","Rural town and fringe in a sparse setting",0,0,0,0,0,0,0,0,0,0,0,0
"2011","Mid Sussex","E07000228","Rural village",3900,2912,1567,1345,38,419,14,405,437,374,63,94
"2011","Mid Sussex","E07000228","Rural village in a sparse setting",0,0,0,0,0,0,0,0,0,0,0,0
"2011","Mid Sussex","E07000228","Rural hamlet and isolated dwellings",3289,2295,1149,1146,14,130,10,120,636,527,109,214
"2011","Mid Sussex","E07000228","Rural hamlet and isolated dwellings in a sparse setting",0,0,0,0,0,0,0,0,0,0,0,0
"2011","Worthing","E07000229","Total",47044,32621,16373,16248,217,4695,988,3707,9102,8424,678,409
"2011","Worthing","E07000229","Urban (total)",47044,32621,16373,16248,217,4695,988,3707,9102,8424,678,409
"2011","Worthing","E07000229","Urban major conurbation",0,0,0,0,0,0,0,0,0,0,0,0
"2011","Worthing","E07000229","Urban minor conurbation",0,0,0,0,0,0,0,0,0,0,0,0
"2011","Worthing","E07000229","Urban city and town",47044,32621,16373,16248,217,4695,988,3707,9102,8424,678,409
"2011","Worthing","E07000229","Urban city and town in a sparse setting",0,0,0,0,0,0,0,0,0,0,0,0
"2011","Worthing","E07000229","Rural (total)",0,0,0,0,0,0,0,0,0,0,0,0
"2011","Worthing","E07000229","Rural town and fringe",0,0,0,0,0,0,0,0,0,0,0,0
"2011","Worthing","E07000229","Rural town and fringe in a sparse setting",0,0,0,0,0,0,0,0,0,0,0,0
"2011","Worthing","E07000229","Rural village",0,0,0,0,0,0,0,0,0,0,0,0
"2011","Worthing","E07000229","Rural village in a sparse setting",0,0,0,0,0,0,0,0,0,0,0,0
"2011","Worthing","E07000229","Rural hamlet and isolated dwellings",0,0,0,0,0,0,0,0,0,0,0,0
"2011","Worthing","E07000229","Rural hamlet and isolated dwellings in a sparse setting",0,0,0,0,0,0,0,0,0,0,0,0
"2011","Bath and North East Somerset","E06000022","Total",73515,49068,25827,23241,368,10614,2528,8086,12447,11408,1039,1018
"2011","Bath and North East Somerset","E06000022","Urban (total)",58763,37421,19672,17749,302,9301,2227,7074,10979,10125,854,760
"2011","Bath and North East Somerset","E06000022","Urban major conurbation",0,0,0,0,0,0,0,0,0,0,0,0
"2011","Bath and North East Somerset","E06000022","Urban minor conurbation",0,0,0,0,0,0,0,0,0,0,0,0
"2011","Bath and North East Somerset","E06000022","Urban city and town",58763,37421,19672,17749,302,9301,2227,7074,10979,10125,854,760
"2011","Bath and North East Somerset","E06000022","Urban city and town in a sparse setting",0,0,0,0,0,0,0,0,0,0,0,0
"2011","Bath and North East Somerset","E06000022","Rural (total)",14752,11647,6155,5492,66,1313,301,1012,1468,1283,185,258
"2011","Bath and North East Somerset","E06000022","Rural town and fringe",6509,5156,2596,2560,39,637,164,473,583,517,66,94
"2011","Bath and North East Somerset","E06000022","Rural town and fringe in a sparse setting",0,0,0,0,0,0,0,0,0,0,0,0
"2011","Bath and North East Somerset","E06000022","Rural village",6512,5054,2775,2279,22,622,130,492,683,591,92,131
"2011","Bath and North East Somerset","E06000022","Rural village in a sparse setting",0,0,0,0,0,0,0,0,0,0,0,0
"2011","Bath and North East Somerset","E06000022","Rural hamlet and isolated dwellings",1731,1437,784,653,5,54,7,47,202,175,27,33
"2011","Bath and North East Somerset","E06000022","Rural hamlet and isolated dwellings in a sparse setting",0,0,0,0,0,0,0,0,0,0,0,0
"2011","Bournemouth","E06000028","Total",82374,47057,22820,24237,569,9206,4895,4311,24685,23234,1451,857
"2011","Bournemouth","E06000028","Urban (total)",82325,47030,22812,24218,569,9201,4891,4310,24670,23220,1450,855
"2011","Bournemouth","E06000028","Urban major conurbation",0,0,0,0,0,0,0,0,0,0,0,0
"2011","Bournemouth","E06000028","Urban minor conurbation",0,0,0,0,0,0,0,0,0,0,0,0
"2011","Bournemouth","E06000028","Urban city and town",82325,47030,22812,24218,569,9201,4891,4310,24670,23220,1450,855
"2011","Bournemouth","E06000028","Urban city and town in a sparse setting",0,0,0,0,0,0,0,0,0,0,0,0
"2011","Bournemouth","E06000028","Rural (total)",49,27,8,19,0,5,4,1,15,14,1,2
"2011","Bournemouth","E06000028","Rural town and fringe",0,0,0,0,0,0,0,0,0,0,0,0
"2011","Bournemouth","E06000028","Rural town and fringe in a sparse setting",0,0,0,0,0,0,0,0,0,0,0,0
"2011","Bournemouth","E06000028","Rural village",0,0,0,0,0,0,0,0,0,0,0,0
"2011","Bournemouth","E06000028","Rural village in a sparse setting",0,0,0,0,0,0,0,0,0,0,0,0
"2011","Bournemouth","E06000028","Rural hamlet and isolated dwellings",49,27,8,19,0,5,4,1,15,14,1,2
"2011","Bournemouth","E06000028","Rural hamlet and isolated dwellings in a sparse setting",0,0,0,0,0,0,0,0,0,0,0,0
"2011","Bristol, City of","E06000023","Total",182747,98708,44928,53780,1385,37083,26494,10589,43028,40401,2627,2543
"2011","Bristol, City of","E06000023","Urban (total)",182747,98708,44928,53780,1385,37083,26494,10589,43028,40401,2627,2543
"2011","Bristol, City of","E06000023","Urban major conurbation",0,0,0,0,0,0,0,0,0,0,0,0
"2011","Bristol, City of","E06000023","Urban minor conurbation",0,0,0,0,0,0,0,0,0,0,0,0
"2011","Bristol, City of","E06000023","Urban city and town",182747,98708,44928,53780,1385,37083,26494,10589,43028,40401,2627,2543
"2011","Bristol, City of","E06000023","Urban city and town in a sparse setting",0,0,0,0,0,0,0,0,0,0,0,0
"2011","Bristol, City of","E06000023","Rural (total)",0,0,0,0,0,0,0,0,0,0,0,0
"2011","Bristol, City of","E06000023","Rural town and fringe",0,0,0,0,0,0,0,0,0,0,0,0
"2011","Bristol, City of","E06000023","Rural town and fringe in a sparse setting",0,0,0,0,0,0,0,0,0,0,0,0
"2011","Bristol, City of","E06000023","Rural village",0,0,0,0,0,0,0,0,0,0,0,0
"2011","Bristol, City of","E06000023","Rural village in a sparse setting",0,0,0,0,0,0,0,0,0,0,0,0
"2011","Bristol, City of","E06000023","Rural hamlet and isolated dwellings",0,0,0,0,0,0,0,0,0,0,0,0
"2011","Bristol, City of","E06000023","Rural hamlet and isolated dwellings in a sparse setting",0,0,0,0,0,0,0,0,0,0,0,0
"2011","Cornwall","E06000052","Total",230389,158524,92113,66411,1757,27655,12833,14822,38605,33938,4667,3848
"2011","Cornwall","E06000052","Urban (total)",89190,57152,30993,26159,664,13361,5789,7572,16733,14820,1913,1280
"2011","Cornwall","E06000052","Urban major conurbation",0,0,0,0,0,0,0,0,0,0,0,0
"2011","Cornwall","E06000052","Urban minor conurbation",0,0,0,0,0,0,0,0,0,0,0,0
"2011","Cornwall","E06000052","Urban city and town",89190,57152,30993,26159,664,13361,5789,7572,16733,14820,1913,1280
"2011","Cornwall","E06000052","Urban city and town in a sparse setting",0,0,0,0,0,0,0,0,0,0,0,0
"2011","Cornwall","E06000052","Rural (total)",141199,101372,61120,40252,1093,14294,7044,7250,21872,19118,2754,2568
"2011","Cornwall","E06000052","Rural town and fringe",53403,36661,20936,15725,516,7059,3212,3847,8409,7420,989,758
"2011","Cornwall","E06000052","Rural town and fringe in a sparse setting",11322,6961,4171,2790,109,1969,1095,874,2096,1911,185,187
"2011","Cornwall","E06000052","Rural village",35279,26329,15944,10385,273,3182,1527,1655,4846,4215,631,649
"2011","Cornwall","E06000052","Rural village in a sparse setting",8594,6501,4294,2207,45,727,404,323,1133,949,184,188
"2011","Cornwall","E06000052","Rural hamlet and isolated dwellings",26823,20518,12818,7700,114,1107,641,466,4470,3846,624,614
"2011","Cornwall","E06000052","Rural hamlet and isolated dwellings in a sparse setting",5778,4402,2957,1445,36,250,165,85,918,777,141,172
"2011","Isles of Scilly","E06000053","Total",989,412,313,99,8,179,121,58,294,204,90,96
"2011","Isles of Scilly","E06000053","Urban (total)",0,0,0,0,0,0,0,0,0,0,0,0
"2011","Isles of Scilly","E06000053","Urban major conurbation",0,0,0,0,0,0,0,0,0,0,0,0
"2011","Isles of Scilly","E06000053","Urban minor conurbation",0,0,0,0,0,0,0,0,0,0,0,0
"2011","Isles of Scilly","E06000053","Urban city and town",0,0,0,0,0,0,0,0,0,0,0,0
"2011","Isles of Scilly","E06000053","Urban city and town in a sparse setting",0,0,0,0,0,0,0,0,0,0,0,0
"2011","Isles of Scilly","E06000053","Rural (total)",989,412,313,99,8,179,121,58,294,204,90,96
"2011","Isles of Scilly","E06000053","Rural town and fringe",0,0,0,0,0,0,0,0,0,0,0,0
"2011","Isles of Scilly","E06000053","Rural town and fringe in a sparse setting",0,0,0,0,0,0,0,0,0,0,0,0
"2011","Isles of Scilly","E06000053","Rural village",0,0,0,0,0,0,0,0,0,0,0,0
"2011","Isles of Scilly","E06000053","Rural village in a sparse setting",935,393,299,94,8,174,120,54,266,181,85,94
"2011","Isles of Scilly","E06000053","Rural hamlet and isolated dwellings",0,0,0,0,0,0,0,0,0,0,0,0
"2011","Isles of Scilly","E06000053","Rural hamlet and isolated dwellings in a sparse setting",54,19,14,5,0,5,1,4,28,23,5,2
"2011","North Somerset","E06000024","Total",88227,64365,32474,31891,542,8103,3104,4999,14270,13058,1212,947
"2011","North Somerset","E06000024","Urban (total)",72731,51763,25417,26346,453,7172,2717,4455,12597,11644,953,746
"2011","North Somerset","E06000024","Urban major conurbation",0,0,0,0,0,0,0,0,0,0,0,0
"2011","North Somerset","E06000024","Urban minor conurbation",0,0,0,0,0,0,0,0,0,0,0,0
"2011","North Somerset","E06000024","Urban city and town",72731,51763,25417,26346,453,7172,2717,4455,12597,11644,953,746
"2011","North Somerset","E06000024","Urban city and town in a sparse setting",0,0,0,0,0,0,0,0,0,0,0,0
"2011","North Somerset","E06000024","Rural (total)",15496,12602,7057,5545,89,931,387,544,1673,1414,259,201
"2011","North Somerset","E06000024","Rural town and fringe",5783,4583,2502,2081,51,473,190,283,622,539,83,54
"2011","North Somerset","E06000024","Rural town and fringe in a sparse setting",0,0,0,0,0,0,0,0,0,0,0,0
"2011","North Somerset","E06000024","Rural village",6445,5393,3042,2351,27,330,148,182,614,520,94,81
"2011","North Somerset","E06000024","Rural village in a sparse setting",0,0,0,0,0,0,0,0,0,0,0,0
"2011","North Somerset","E06000024","Rural hamlet and isolated dwellings",3268,2626,1513,1113,11,128,49,79,437,355,82,66
"2011","North Somerset","E06000024","Rural hamlet and isolated dwellings in a sparse setting",0,0,0,0,0,0,0,0,0,0,0,0
"2011","Plymouth","E06000026","Total",109307,64157,29763,34394,841,21095,9403,11692,22026,19431,2595,1188
"2011","Plymouth","E06000026","Urban (total)",109307,64157,29763,34394,841,21095,9403,11692,22026,19431,2595,1188
"2011","Plymouth","E06000026","Urban major conurbation",0,0,0,0,0,0,0,0,0,0,0,0
"2011","Plymouth","E06000026","Urban minor conurbation",0,0,0,0,0,0,0,0,0,0,0,0
"2011","Plymouth","E06000026","Urban city and town",109307,64157,29763,34394,841,21095,9403,11692,22026,19431,2595,1188
"2011","Plymouth","E06000026","Urban city and town in a sparse setting",0,0,0,0,0,0,0,0,0,0,0,0
"2011","Plymouth","E06000026","Rural (total)",0,0,0,0,0,0,0,0,0,0,0,0
"2011","Plymouth","E06000026","Rural town and fringe",0,0,0,0,0,0,0,0,0,0,0,0
"2011","Plymouth","E06000026","Rural town and fringe in a sparse setting",0,0,0,0,0,0,0,0,0,0,0,0
"2011","Plymouth","E06000026","Rural village",0,0,0,0,0,0,0,0,0,0,0,0
"2011","Plymouth","E06000026","Rural village in a sparse setting",0,0,0,0,0,0,0,0,0,0,0,0
"2011","Plymouth","E06000026","Rural hamlet and isolated dwellings",0,0,0,0,0,0,0,0,0,0,0,0
"2011","Plymouth","E06000026","Rural hamlet and isolated dwellings in a sparse setting",0,0,0,0,0,0,0,0,0,0,0,0
"2011","Poole","E06000029","Total",63530,44702,22719,21983,557,7324,4143,3181,10275,9293,982,672
"2011","Poole","E06000029","Urban (total)",63433,44618,22669,21949,557,7324,4143,3181,10266,9286,980,668
"2011","Poole","E06000029","Urban major conurbation",0,0,0,0,0,0,0,0,0,0,0,0
"2011","Poole","E06000029","Urban minor conurbation",0,0,0,0,0,0,0,0,0,0,0,0
"2011","Poole","E06000029","Urban city and town",63433,44618,22669,21949,557,7324,4143,3181,10266,9286,980,668
"2011","Poole","E06000029","Urban city and town in a sparse setting",0,0,0,0,0,0,0,0,0,0,0,0
"2011","Poole","E06000029","Rural (total)",97,84,50,34,0,0,0,0,9,7,2,4
"2011","Poole","E06000029","Rural town and fringe",0,0,0,0,0,0,0,0,0,0,0,0
"2011","Poole","E06000029","Rural town and fringe in a sparse setting",0,0,0,0,0,0,0,0,0,0,0,0
"2011","Poole","E06000029","Rural village",0,0,0,0,0,0,0,0,0,0,0,0
"2011","Poole","E06000029","Rural village in a sparse setting",0,0,0,0,0,0,0,0,0,0,0,0
"2011","Poole","E06000029","Rural hamlet and isolated dwellings",97,84,50,34,0,0,0,0,9,7,2,4
"2011","Poole","E06000029","Rural hamlet and isolated dwellings in a sparse setting",0,0,0,0,0,0,0,0,0,0,0,0
"2011","South Gloucestershire","E06000025","Total",107538,80586,37050,43536,497,10633,2063,8570,14600,13124,1476,1222
"2011","South Gloucestershire","E06000025","Urban (total)",94022,69976,31594,38382,440,9637,1860,7777,13036,11765,1271,933
"2011","South Gloucestershire","E06000025","Urban major conurbation",0,0,0,0,0,0,0,0,0,0,0,0
"2011","South Gloucestershire","E06000025","Urban minor conurbation",0,0,0,0,0,0,0,0,0,0,0,0
"2011","South Gloucestershire","E06000025","Urban city and town",94022,69976,31594,38382,440,9637,1860,7777,13036,11765,1271,933
"2011","South Gloucestershire","E06000025","Urban city and town in a sparse setting",0,0,0,0,0,0,0,0,0,0,0,0
"2011","South Gloucestershire","E06000025","Rural (total)",13516,10610,5456,5154,57,996,203,793,1564,1359,205,289
"2011","South Gloucestershire","E06000025","Rural town and fringe",5591,4546,2306,2240,18,462,98,364,491,433,58,74
"2011","South Gloucestershire","E06000025","Rural town and fringe in a sparse setting",0,0,0,0,0,0,0,0,0,0,0,0
"2011","South Gloucestershire","E06000025","Rural village",4726,3630,1842,1788,29,378,74,304,567,478,89,122
"2011","South Gloucestershire","E06000025","Rural village in a sparse setting",0,0,0,0,0,0,0,0,0,0,0,0
"2011","South Gloucestershire","E06000025","Rural hamlet and isolated dwellings",3199,2434,1308,1126,10,156,31,125,506,448,58,93
"2011","South Gloucestershire","E06000025","Rural hamlet and isolated dwellings in a sparse setting",0,0,0,0,0,0,0,0,0,0,0,0
"2011","Swindon","E06000030","Total",88360,57902,22749,35153,1118,14382,10269,4113,14169,13020,1149,789
"2011","Swindon","E06000030","Urban (total)",78377,50658,19101,31557,996,12939,9309,3630,13135,12154,981,649
"2011","Swindon","E06000030","Urban major conurbation",0,0,0,0,0,0,0,0,0,0,0,0
"2011","Swindon","E06000030","Urban minor conurbation",0,0,0,0,0,0,0,0,0,0,0,0
"2011","Swindon","E06000030","Urban city and town",78377,50658,19101,31557,996,12939,9309,3630,13135,12154,981,649
"2011","Swindon","E06000030","Urban city and town in a sparse setting",0,0,0,0,0,0,0,0,0,0,0,0
"2011","Swindon","E06000030","Rural (total)",9983,7244,3648,3596,122,1443,960,483,1034,866,168,140
"2011","Swindon","E06000030","Rural town and fringe",8126,5972,3116,2856,94,1256,849,407,710,607,103,94
"2011","Swindon","E06000030","Rural town and fringe in a sparse setting",0,0,0,0,0,0,0,0,0,0,0,0
"2011","Swindon","E06000030","Rural village",1267,857,330,527,25,158,87,71,198,154,44,29
"2011","Swindon","E06000030","Rural village in a sparse setting",0,0,0,0,0,0,0,0,0,0,0,0
"2011","Swindon","E06000030","Rural hamlet and isolated dwellings",590,415,202,213,3,29,24,5,126,105,21,17
"2011","Swindon","E06000030","Rural hamlet and isolated dwellings in a sparse setting",0,0,0,0,0,0,0,0,0,0,0,0
"2011","Torbay","E06000027","Total",59010,39424,21503,17921,554,4762,505,4257,13696,12647,1049,574
"2011","Torbay","E06000027","Urban (total)",58668,39182,21347,17835,552,4751,503,4248,13610,12564,1046,573
"2011","Torbay","E06000027","Urban major conurbation",0,0,0,0,0,0,0,0,0,0,0,0
"2011","Torbay","E06000027","Urban minor conurbation",0,0,0,0,0,0,0,0,0,0,0,0
"2011","Torbay","E06000027","Urban city and town",58668,39182,21347,17835,552,4751,503,4248,13610,12564,1046,573
"2011","Torbay","E06000027","Urban city and town in a sparse setting",0,0,0,0,0,0,0,0,0,0,0,0
"2011","Torbay","E06000027","Rural (total)",342,242,156,86,2,11,2,9,86,83,3,1
"2011","Torbay","E06000027","Rural town and fringe",0,0,0,0,0,0,0,0,0,0,0,0
"2011","Torbay","E06000027","Rural town and fringe in a sparse setting",0,0,0,0,0,0,0,0,0,0,0,0
"2011","Torbay","E06000027","Rural village",221,164,119,45,2,8,2,6,47,47,0,0
"2011","Torbay","E06000027","Rural village in a sparse setting",0,0,0,0,0,0,0,0,0,0,0,0
"2011","Torbay","E06000027","Rural hamlet and isolated dwellings",121,78,37,41,0,3,0,3,39,36,3,1
"2011","Torbay","E06000027","Rural hamlet and isolated dwellings in a sparse setting",0,0,0,0,0,0,0,0,0,0,0,0
"2011","Wiltshire","E06000054","Total",194194,131083,65734,65349,1463,28591,7604,20987,29968,22903,7065,3089
"2011","Wiltshire","E06000054","Urban (total)",104506,69934,32327,37607,904,17254,4341,12913,15293,13103,2190,1121
"2011","Wiltshire","E06000054","Urban major conurbation",0,0,0,0,0,0,0,0,0,0,0,0
"2011","Wiltshire","E06000054","Urban minor conurbation",0,0,0,0,0,0,0,0,0,0,0,0
"2011","Wiltshire","E06000054","Urban city and town",104506,69934,32327,37607,904,17254,4341,12913,15293,13103,2190,1121
"2011","Wiltshire","E06000054","Urban city and town in a sparse setting",0,0,0,0,0,0,0,0,0,0,0,0
"2011","Wiltshire","E06000054","Rural (total)",89688,61149,33407,27742,559,11337,3263,8074,14675,9800,4875,1968
"2011","Wiltshire","E06000054","Rural town and fringe",36194,23463,12313,11150,287,6236,1754,4482,5697,3832,1865,511
"2011","Wiltshire","E06000054","Rural town and fringe in a sparse setting",0,0,0,0,0,0,0,0,0,0,0,0
"2011","Wiltshire","E06000054","Rural village",37808,26720,14830,11890,175,4099,1190,2909,5936,3700,2236,878
"2011","Wiltshire","E06000054","Rural village in a sparse setting",0,0,0,0,0,0,0,0,0,0,0,0
"2011","Wiltshire","E06000054","Rural hamlet and isolated dwellings",15686,10966,6264,4702,97,1002,319,683,3042,2268,774,579
"2011","Wiltshire","E06000054","Rural hamlet and isolated dwellings in a sparse setting",0,0,0,0,0,0,0,0,0,0,0,0
"2011","East Devon","E07000040","Total",59071,44283,27837,16446,319,5515,3915,1600,8041,7034,1007,913
"2011","East Devon","E07000040","Urban (total)",26791,19508,11847,7661,139,2890,1983,907,3904,3493,411,350
"2011","East Devon","E07000040","Urban major conurbation",0,0,0,0,0,0,0,0,0,0,0,0
"2011","East Devon","E07000040","Urban minor conurbation",0,0,0,0,0,0,0,0,0,0,0,0
"2011","East Devon","E07000040","Urban city and town",26791,19508,11847,7661,139,2890,1983,907,3904,3493,411,350
"2011","East Devon","E07000040","Urban city and town in a sparse setting",0,0,0,0,0,0,0,0,0,0,0,0
"2011","East Devon","E07000040","Rural (total)",32280,24775,15990,8785,180,2625,1932,693,4137,3541,596,563
"2011","East Devon","E07000040","Rural town and fringe",16525,12338,7930,4408,112,1680,1207,473,2163,1866,297,232
"2011","East Devon","E07000040","Rural town and fringe in a sparse setting",0,0,0,0,0,0,0,0,0,0,0,0
"2011","East Devon","E07000040","Rural village",8319,6511,4140,2371,35,611,500,111,995,874,121,167
"2011","East Devon","E07000040","Rural village in a sparse setting",0,0,0,0,0,0,0,0,0,0,0,0
"2011","East Devon","E07000040","Rural hamlet and isolated dwellings",7436,5926,3920,2006,33,334,225,109,979,801,178,164
"2011","East Devon","E07000040","Rural hamlet and isolated dwellings in a sparse setting",0,0,0,0,0,0,0,0,0,0,0,0
"2011","Exeter","E07000041","Total",49242,29443,14809,14634,470,8386,4769,3617,10336,9633,703,607
"2011","Exeter","E07000041","Urban (total)",49017,29290,14780,14510,464,8366,4768,3598,10293,9594,699,604
"2011","Exeter","E07000041","Urban major conurbation",0,0,0,0,0,0,0,0,0,0,0,0
"2011","Exeter","E07000041","Urban minor conurbation",0,0,0,0,0,0,0,0,0,0,0,0
"2011","Exeter","E07000041","Urban city and town",49017,29290,14780,14510,464,8366,4768,3598,10293,9594,699,604
"2011","Exeter","E07000041","Urban city and town in a sparse setting",0,0,0,0,0,0,0,0,0,0,0,0
"2011","Exeter","E07000041","Rural (total)",225,153,29,124,6,20,1,19,43,39,4,3
"2011","Exeter","E07000041","Rural town and fringe",0,0,0,0,0,0,0,0,0,0,0,0
"2011","Exeter","E07000041","Rural town and fringe in a sparse setting",0,0,0,0,0,0,0,0,0,0,0,0
"2011","Exeter","E07000041","Rural village",225,153,29,124,6,20,1,19,43,39,4,3
"2011","Exeter","E07000041","Rural village in a sparse setting",0,0,0,0,0,0,0,0,0,0,0,0
"2011","Exeter","E07000041","Rural hamlet and isolated dwellings",0,0,0,0,0,0,0,0,0,0,0,0
"2011","Exeter","E07000041","Rural hamlet and isolated dwellings in a sparse setting",0,0,0,0,0,0,0,0,0,0,0,0
"2011","Mid Devon","E07000042","Total",32758,22626,12206,10420,305,4135,2843,1292,5091,4605,486,601
"2011","Mid Devon","E07000042","Urban (total)",8448,4937,2522,2415,113,1627,1161,466,1612,1470,142,159
"2011","Mid Devon","E07000042","Urban major conurbation",0,0,0,0,0,0,0,0,0,0,0,0
"2011","Mid Devon","E07000042","Urban minor conurbation",0,0,0,0,0,0,0,0,0,0,0,0
"2011","Mid Devon","E07000042","Urban city and town",8448,4937,2522,2415,113,1627,1161,466,1612,1470,142,159
"2011","Mid Devon","E07000042","Urban city and town in a sparse setting",0,0,0,0,0,0,0,0,0,0,0,0
"2011","Mid Devon","E07000042","Rural (total)",24310,17689,9684,8005,192,2508,1682,826,3479,3135,344,442
"2011","Mid Devon","E07000042","Rural town and fringe",11585,7861,3990,3871,130,1702,1041,661,1743,1597,146,149
"2011","Mid Devon","E07000042","Rural town and fringe in a sparse setting",0,0,0,0,0,0,0,0,0,0,0,0
"2011","Mid Devon","E07000042","Rural village",4848,3600,1944,1656,32,548,434,114,574,524,50,94
"2011","Mid Devon","E07000042","Rural village in a sparse setting",729,527,289,238,2,75,64,11,112,98,14,13
"2011","Mid Devon","E07000042","Rural hamlet and isolated dwellings",5927,4726,2860,1866,22,131,94,37,898,783,115,150
"2011","Mid Devon","E07000042","Rural hamlet and isolated dwellings in a sparse setting",1221,975,601,374,6,52,49,3,152,133,19,36
"2011","North Devon","E07000043","Total",40001,27383,15638,11745,271,4316,971,3345,7341,6377,964,690
"2011","North Devon","E07000043","Urban (total)",18709,11546,5914,5632,125,2768,641,2127,4044,3715,329,226
"2011","North Devon","E07000043","Urban major conurbation",0,0,0,0,0,0,0,0,0,0,0,0
"2011","North Devon","E07000043","Urban minor conurbation",0,0,0,0,0,0,0,0,0,0,0,0
"2011","North Devon","E07000043","Urban city and town",13805,8674,4424,4250,106,2236,549,1687,2631,2384,247,158
"2011","North Devon","E07000043","Urban city and town in a sparse setting",4904,2872,1490,1382,19,532,92,440,1413,1331,82,68
"2011","North Devon","E07000043","Rural (total)",21292,15837,9724,6113,146,1548,330,1218,3297,2662,635,464
"2011","North Devon","E07000043","Rural town and fringe",5769,4553,2729,1824,52,465,96,369,623,540,83,76
"2011","North Devon","E07000043","Rural town and fringe in a sparse setting",5011,3369,2040,1329,57,555,113,442,914,816,98,116
"2011","North Devon","E07000043","Rural village",3038,2191,1302,889,11,198,51,147,591,353,238,47
"2011","North Devon","E07000043","Rural village in a sparse setting",1277,882,533,349,1,153,27,126,211,176,35,30
"2011","North Devon","E07000043","Rural hamlet and isolated dwellings",2837,2182,1367,815,12,73,16,57,490,392,98,80
"2011","North Devon","E07000043","Rural hamlet and isolated dwellings in a sparse setting",3360,2660,1753,907,13,104,27,77,468,385,83,115
"2011","South Hams","E07000044","Total",36858,26440,15775,10665,400,4195,642,3553,5259,4638,621,564
"2011","South Hams","E07000044","Urban (total)",7172,5683,2475,3208,88,471,66,405,861,777,84,69
"2011","South Hams","E07000044","Urban major conurbation",0,0,0,0,0,0,0,0,0,0,0,0
"2011","South Hams","E07000044","Urban minor conurbation",0,0,0,0,0,0,0,0,0,0,0,0
"2011","South Hams","E07000044","Urban city and town",7172,5683,2475,3208,88,471,66,405,861,777,84,69
"2011","South Hams","E07000044","Urban city and town in a sparse setting",0,0,0,0,0,0,0,0,0,0,0,0
"2011","South Hams","E07000044","Rural (total)",29686,20757,13300,7457,312,3724,576,3148,4398,3861,537,495
"2011","South Hams","E07000044","Rural town and fringe",14821,9794,6276,3518,175,2489,393,2096,2150,1896,254,213
"2011","South Hams","E07000044","Rural town and fringe in a sparse setting",288,171,135,36,0,72,8,64,40,33,7,5
"2011","South Hams","E07000044","Rural village",8580,6290,4051,2239,84,870,116,754,1194,1043,151,142
"2011","South Hams","E07000044","Rural village in a sparse setting",151,107,72,35,2,24,5,19,17,17,0,1
"2011","South Hams","E07000044","Rural hamlet and isolated dwellings",5658,4252,2669,1583,51,248,50,198,976,852,124,131
"2011","South Hams","E07000044","Rural hamlet and isolated dwellings in a sparse setting",188,143,97,46,0,21,4,17,21,20,1,3
"2011","Teignbridge","E07000045","Total",54003,39678,22015,17663,495,4813,1169,3644,8358,7526,832,659
"2011","Teignbridge","E07000045","Urban (total)",29188,20675,11070,9605,294,2890,656,2234,4989,4515,474,340
"2011","Teignbridge","E07000045","Urban major conurbation",0,0,0,0,0,0,0,0,0,0,0,0
"2011","Teignbridge","E07000045","Urban minor conurbation",0,0,0,0,0,0,0,0,0,0,0,0
"2011","Teignbridge","E07000045","Urban city and town",29188,20675,11070,9605,294,2890,656,2234,4989,4515,474,340
"2011","Teignbridge","E07000045","Urban city and town in a sparse setting",0,0,0,0,0,0,0,0,0,0,0,0
"2011","Teignbridge","E07000045","Rural (total)",24815,19003,10945,8058,201,1923,513,1410,3369,3011,358,319
"2011","Teignbridge","E07000045","Rural town and fringe",15587,11712,6281,5431,147,1503,381,1122,2062,1856,206,163
"2011","Teignbridge","E07000045","Rural town and fringe in a sparse setting",0,0,0,0,0,0,0,0,0,0,0,0
"2011","Teignbridge","E07000045","Rural village",4190,3439,2243,1196,25,257,85,172,425,380,45,44
"2011","Teignbridge","E07000045","Rural village in a sparse setting",0,0,0,0,0,0,0,0,0,0,0,0
"2011","Teignbridge","E07000045","Rural hamlet and isolated dwellings",5038,3852,2421,1431,29,163,47,116,882,775,107,112
"2011","Teignbridge","E07000045","Rural hamlet and isolated dwellings in a sparse setting",0,0,0,0,0,0,0,0,0,0,0,0
"2011","Torridge","E07000046","Total",27986,19998,11998,8000,197,2524,542,1982,4746,4275,471,521
"2011","Torridge","E07000046","Urban (total)",13158,8912,5135,3777,126,1541,335,1206,2389,2197,192,190
"2011","Torridge","E07000046","Urban major conurbation",0,0,0,0,0,0,0,0,0,0,0,0
"2011","Torridge","E07000046","Urban minor conurbation",0,0,0,0,0,0,0,0,0,0,0,0
"2011","Torridge","E07000046","Urban city and town",13158,8912,5135,3777,126,1541,335,1206,2389,2197,192,190
"2011","Torridge","E07000046","Urban city and town in a sparse setting",0,0,0,0,0,0,0,0,0,0,0,0
"2011","Torridge","E07000046","Rural (total)",14828,11086,6863,4223,71,983,207,776,2357,2078,279,331
"2011","Torridge","E07000046","Rural town and fringe",2438,1621,862,759,5,306,55,251,477,433,44,29
"2011","Torridge","E07000046","Rural town and fringe in a sparse setting",1656,1071,661,410,16,202,32,170,337,314,23,30
"2011","Torridge","E07000046","Rural village",1177,929,567,362,8,50,12,38,157,139,18,33
"2011","Torridge","E07000046","Rural village in a sparse setting",3616,2638,1602,1036,10,260,56,204,612,545,67,96
"2011","Torridge","E07000046","Rural hamlet and isolated dwellings",1811,1513,972,541,9,58,21,37,203,168,35,28
"2011","Torridge","E07000046","Rural hamlet and isolated dwellings in a sparse setting",4130,3314,2199,1115,23,107,31,76,571,479,92,115
"2011","West Devon","E07000047","Total",22725,16630,10003,6627,148,2158,582,1576,3409,3025,384,380
"2011","West Devon","E07000047","Urban (total)",5467,3847,2269,1578,51,641,177,464,836,776,60,92
"2011","West Devon","E07000047","Urban major conurbation",0,0,0,0,0,0,0,0,0,0,0,0
"2011","West Devon","E07000047","Urban minor conurbation",0,0,0,0,0,0,0,0,0,0,0,0
"2011","West Devon","E07000047","Urban city and town",5467,3847,2269,1578,51,641,177,464,836,776,60,92
"2011","West Devon","E07000047","Urban city and town in a sparse setting",0,0,0,0,0,0,0,0,0,0,0,0
"2011","West Devon","E07000047","Rural (total)",17258,12783,7734,5049,97,1517,405,1112,2573,2249,324,288
"2011","West Devon","E07000047","Rural town and fringe",2911,2073,1249,824,20,410,111,299,375,311,64,33
"2011","West Devon","E07000047","Rural town and fringe in a sparse setting",4353,2957,1627,1330,27,512,111,401,816,743,73,41
"2011","West Devon","E07000047","Rural village",3004,2320,1366,954,13,246,76,170,377,319,58,48
"2011","West Devon","E07000047","Rural village in a sparse setting",1573,1161,698,463,15,150,32,118,213,187,26,34
"2011","West Devon","E07000047","Rural hamlet and isolated dwellings",3100,2444,1549,895,9,123,51,72,466,418,48,58
"2011","West Devon","E07000047","Rural hamlet and isolated dwellings in a sparse setting",2317,1828,1245,583,13,76,24,52,326,271,55,74
"2011","Christchurch","E07000048","Total",21475,15967,9814,6153,182,2784,200,2584,2321,2115,206,221
"2011","Christchurch","E07000048","Urban (total)",21216,15797,9739,6058,181,2762,197,2565,2264,2063,201,212
"2011","Christchurch","E07000048","Urban major conurbation",0,0,0,0,0,0,0,0,0,0,0,0
"2011","Christchurch","E07000048","Urban minor conurbation",0,0,0,0,0,0,0,0,0,0,0,0
"2011","Christchurch","E07000048","Urban city and town",21216,15797,9739,6058,181,2762,197,2565,2264,2063,201,212
"2011","Christchurch","E07000048","Urban city and town in a sparse setting",0,0,0,0,0,0,0,0,0,0,0,0
"2011","Christchurch","E07000048","Rural (total)",259,170,75,95,1,22,3,19,57,52,5,9
"2011","Christchurch","E07000048","Rural town and fringe",0,0,0,0,0,0,0,0,0,0,0,0
"2011","Christchurch","E07000048","Rural town and fringe in a sparse setting",0,0,0,0,0,0,0,0,0,0,0,0
"2011","Christchurch","E07000048","Rural village",0,0,0,0,0,0,0,0,0,0,0,0
"2011","Christchurch","E07000048","Rural village in a sparse setting",0,0,0,0,0,0,0,0,0,0,0,0
"2011","Christchurch","E07000048","Rural hamlet and isolated dwellings",259,170,75,95,1,22,3,19,57,52,5,9
"2011","Christchurch","E07000048","Rural hamlet and isolated dwellings in a sparse setting",0,0,0,0,0,0,0,0,0,0,0,0
"2011","East Dorset","E07000049","Total",37564,30371,18017,12354,111,3120,292,2828,3471,3028,443,491
"2011","East Dorset","E07000049","Urban (total)",28826,23570,13892,9678,94,2457,249,2208,2456,2163,293,249
"2011","East Dorset","E07000049","Urban major conurbation",0,0,0,0,0,0,0,0,0,0,0,0
"2011","East Dorset","E07000049","Urban minor conurbation",0,0,0,0,0,0,0,0,0,0,0,0
"2011","East Dorset","E07000049","Urban city and town",28826,23570,13892,9678,94,2457,249,2208,2456,2163,293,249
"2011","East Dorset","E07000049","Urban city and town in a sparse setting",0,0,0,0,0,0,0,0,0,0,0,0
"2011","East Dorset","E07000049","Rural (total)",8738,6801,4125,2676,17,663,43,620,1015,865,150,242
"2011","East Dorset","E07000049","Rural town and fringe",3470,2973,1782,1191,8,273,16,257,175,150,25,41
"2011","East Dorset","E07000049","Rural town and fringe in a sparse setting",0,0,0,0,0,0,0,0,0,0,0,0
"2011","East Dorset","E07000049","Rural village",2113,1452,793,659,5,238,17,221,356,308,48,62
"2011","East Dorset","E07000049","Rural village in a sparse setting",0,0,0,0,0,0,0,0,0,0,0,0
"2011","East Dorset","E07000049","Rural hamlet and isolated dwellings",3155,2376,1550,826,4,152,10,142,484,407,77,139
"2011","East Dorset","E07000049","Rural hamlet and isolated dwellings in a sparse setting",0,0,0,0,0,0,0,0,0,0,0,0
"2011","North Dorset","E07000050","Total",28670,20002,11286,8716,217,3865,282,3583,4094,3247,847,492
"2011","North Dorset","E07000050","Urban (total)",10041,6822,3306,3516,107,1553,117,1436,1454,1308,146,105
"2011","North Dorset","E07000050","Urban major conurbation",0,0,0,0,0,0,0,0,0,0,0,0
"2011","North Dorset","E07000050","Urban minor conurbation",0,0,0,0,0,0,0,0,0,0,0,0
"2011","North Dorset","E07000050","Urban city and town",10041,6822,3306,3516,107,1553,117,1436,1454,1308,146,105
"2011","North Dorset","E07000050","Urban city and town in a sparse setting",0,0,0,0,0,0,0,0,0,0,0,0
"2011","North Dorset","E07000050","Rural (total)",18629,13180,7980,5200,110,2312,165,2147,2640,1939,701,387
"2011","North Dorset","E07000050","Rural town and fringe",5966,4070,2249,1821,51,979,64,915,798,717,81,68
"2011","North Dorset","E07000050","Rural town and fringe in a sparse setting",0,0,0,0,0,0,0,0,0,0,0,0
"2011","North Dorset","E07000050","Rural village",9628,6841,4257,2584,54,1129,79,1050,1420,871,549,184
"2011","North Dorset","E07000050","Rural village in a sparse setting",0,0,0,0,0,0,0,0,0,0,0,0
"2011","North Dorset","E07000050","Rural hamlet and isolated dwellings",3035,2269,1474,795,5,204,22,182,422,351,71,135
"2011","North Dorset","E07000050","Rural hamlet and isolated dwellings in a sparse setting",0,0,0,0,0,0,0,0,0,0,0,0
"2011","Purbeck","E07000051","Total",19583,13613,8306,5307,165,2446,444,2002,3005,2391,614,354
"2011","Purbeck","E07000051","Urban (total)",7989,5924,3635,2289,75,806,146,660,1090,976,114,94
"2011","Purbeck","E07000051","Urban major conurbation",0,0,0,0,0,0,0,0,0,0,0,0
"2011","Purbeck","E07000051","Urban minor conurbation",0,0,0,0,0,0,0,0,0,0,0,0
"2011","Purbeck","E07000051","Urban city and town",7989,5924,3635,2289,75,806,146,660,1090,976,114,94
"2011","Purbeck","E07000051","Urban city and town in a sparse setting",0,0,0,0,0,0,0,0,0,0,0,0
"2011","Purbeck","E07000051","Rural (total)",11594,7689,4671,3018,90,1640,298,1342,1915,1415,500,260
"2011","Purbeck","E07000051","Rural town and fringe",6197,4366,2576,1790,51,1010,192,818,693,612,81,77
"2011","Purbeck","E07000051","Rural town and fringe in a sparse setting",0,0,0,0,0,0,0,0,0,0,0,0
"2011","Purbeck","E07000051","Rural village",3400,2044,1220,824,27,489,76,413,765,420,345,75
"2011","Purbeck","E07000051","Rural village in a sparse setting",0,0,0,0,0,0,0,0,0,0,0,0
"2011","Purbeck","E07000051","Rural hamlet and isolated dwellings",1997,1279,875,404,12,141,30,111,457,383,74,108
"2011","Purbeck","E07000051","Rural hamlet and isolated dwellings in a sparse setting",0,0,0,0,0,0,0,0,0,0,0,0
"2011","West Dorset","E07000052","Total",44386,30823,19563,11260,370,6159,367,5792,6093,5419,674,941
"2011","West Dorset","E07000052","Urban (total)",17479,11891,7115,4776,148,2892,175,2717,2341,2122,219,207
"2011","West Dorset","E07000052","Urban major conurbation",0,0,0,0,0,0,0,0,0,0,0,0
"2011","West Dorset","E07000052","Urban minor conurbation",0,0,0,0,0,0,0,0,0,0,0,0
"2011","West Dorset","E07000052","Urban city and town",17479,11891,7115,4776,148,2892,175,2717,2341,2122,219,207
"2011","West Dorset","E07000052","Urban city and town in a sparse setting",0,0,0,0,0,0,0,0,0,0,0,0
"2011","West Dorset","E07000052","Rural (total)",26907,18932,12448,6484,222,3267,192,3075,3752,3297,455,734
"2011","West Dorset","E07000052","Rural town and fringe",11196,7454,4808,2646,97,1933,110,1823,1475,1328,147,237
"2011","West Dorset","E07000052","Rural town and fringe in a sparse setting",131,121,101,20,1,1,0,1,7,4,3,1
"2011","West Dorset","E07000052","Rural village",11118,8319,5424,2895,97,1063,55,1008,1352,1182,170,287
"2011","West Dorset","E07000052","Rural village in a sparse setting",0,0,0,0,0,0,0,0,0,0,0,0
"2011","West Dorset","E07000052","Rural hamlet and isolated dwellings",4462,3038,2115,923,27,270,27,243,918,783,135,209
"2011","West Dorset","E07000052","Rural hamlet and isolated dwellings in a sparse setting",0,0,0,0,0,0,0,0,0,0,0,0
"2011","Weymouth and Portland","E07000053","Total",28535,19061,10421,8640,161,3894,1293,2601,5073,4651,422,346
"2011","Weymouth and Portland","E07000053","Urban (total)",23179,15405,8535,6870,129,3188,1056,2132,4159,3814,345,298
"2011","Weymouth and Portland","E07000053","Urban major conurbation",0,0,0,0,0,0,0,0,0,0,0,0
"2011","Weymouth and Portland","E07000053","Urban minor conurbation",0,0,0,0,0,0,0,0,0,0,0,0
"2011","Weymouth and Portland","E07000053","Urban city and town",23179,15405,8535,6870,129,3188,1056,2132,4159,3814,345,298
"2011","Weymouth and Portland","E07000053","Urban city and town in a sparse setting",0,0,0,0,0,0,0,0,0,0,0,0
"2011","Weymouth and Portland","E07000053","Rural (total)",5356,3656,1886,1770,32,706,237,469,914,837,77,48
"2011","Weymouth and Portland","E07000053","Rural town and fringe",5100,3456,1766,1690,32,700,237,463,872,798,74,40
"2011","Weymouth and Portland","E07000053","Rural town and fringe in a sparse setting",0,0,0,0,0,0,0,0,0,0,0,0
"2011","Weymouth and Portland","E07000053","Rural village",75,68,34,34,0,3,0,3,4,4,0,0
"2011","Weymouth and Portland","E07000053","Rural village in a sparse setting",0,0,0,0,0,0,0,0,0,0,0,0
"2011","Weymouth and Portland","E07000053","Rural hamlet and isolated dwellings",181,132,86,46,0,3,0,3,38,35,3,8
"2011","Weymouth and Portland","E07000053","Rural hamlet and isolated dwellings in a sparse setting",0,0,0,0,0,0,0,0,0,0,0,0
"2011","Cheltenham","E07000078","Total",50929,32879,16363,16516,360,6227,4091,2136,10925,10260,665,538
"2011","Cheltenham","E07000078","Urban (total)",50790,32755,16279,16476,360,6226,4091,2135,10912,10247,665,537
"2011","Cheltenham","E07000078","Urban major conurbation",0,0,0,0,0,0,0,0,0,0,0,0
"2011","Cheltenham","E07000078","Urban minor conurbation",0,0,0,0,0,0,0,0,0,0,0,0
"2011","Cheltenham","E07000078","Urban city and town",50790,32755,16279,16476,360,6226,4091,2135,10912,10247,665,537
"2011","Cheltenham","E07000078","Urban city and town in a sparse setting",0,0,0,0,0,0,0,0,0,0,0,0
"2011","Cheltenham","E07000078","Rural (total)",139,124,84,40,0,1,0,1,13,13,0,1
"2011","Cheltenham","E07000078","Rural town and fringe",139,124,84,40,0,1,0,1,13,13,0,1
"2011","Cheltenham","E07000078","Rural town and fringe in a sparse setting",0,0,0,0,0,0,0,0,0,0,0,0
"2011","Cheltenham","E07000078","Rural village",0,0,0,0,0,0,0,0,0,0,0,0
"2011","Cheltenham","E07000078","Rural village in a sparse setting",0,0,0,0,0,0,0,0,0,0,0,0
"2011","Cheltenham","E07000078","Rural hamlet and isolated dwellings",0,0,0,0,0,0,0,0,0,0,0,0
"2011","Cheltenham","E07000078","Rural hamlet and isolated dwellings in a sparse setting",0,0,0,0,0,0,0,0,0,0,0,0
"2011","Cotswold","E07000079","Total",36236,23803,13691,10112,441,5388,623,4765,5518,4767,751,1086
"2011","Cotswold","E07000079","Urban (total)",7754,4605,2453,2152,71,1776,206,1570,1210,1096,114,92
"2011","Cotswold","E07000079","Urban major conurbation",0,0,0,0,0,0,0,0,0,0,0,0
"2011","Cotswold","E07000079","Urban minor conurbation",0,0,0,0,0,0,0,0,0,0,0,0
"2011","Cotswold","E07000079","Urban city and town",7754,4605,2453,2152,71,1776,206,1570,1210,1096,114,92
"2011","Cotswold","E07000079","Urban city and town in a sparse setting",0,0,0,0,0,0,0,0,0,0,0,0
"2011","Cotswold","E07000079","Rural (total)",28482,19198,11238,7960,370,3612,417,3195,4308,3671,637,994
"2011","Cotswold","E07000079","Rural town and fringe",13097,9102,5353,3749,207,2067,233,1834,1495,1306,189,226
"2011","Cotswold","E07000079","Rural town and fringe in a sparse setting",0,0,0,0,0,0,0,0,0,0,0,0
"2011","Cotswold","E07000079","Rural village",10493,7023,3986,3037,138,1175,129,1046,1713,1433,280,444
"2011","Cotswold","E07000079","Rural village in a sparse setting",0,0,0,0,0,0,0,0,0,0,0,0
"2011","Cotswold","E07000079","Rural hamlet and isolated dwellings",4892,3073,1899,1174,25,370,55,315,1100,932,168,324
"2011","Cotswold","E07000079","Rural hamlet and isolated dwellings in a sparse setting",0,0,0,0,0,0,0,0,0,0,0,0
"2011","Forest of Dean","E07000080","Total",34167,25371,13966,11405,186,4237,773,3464,3835,3261,574,538
"2011","Forest of Dean","E07000080","Urban (total)",11709,8249,4315,3934,38,1846,346,1500,1408,1264,144,168
"2011","Forest of Dean","E07000080","Urban major conurbation",0,0,0,0,0,0,0,0,0,0,0,0
"2011","Forest of Dean","E07000080","Urban minor conurbation",0,0,0,0,0,0,0,0,0,0,0,0
"2011","Forest of Dean","E07000080","Urban city and town",11709,8249,4315,3934,38,1846,346,1500,1408,1264,144,168
"2011","Forest of Dean","E07000080","Urban city and town in a sparse setting",0,0,0,0,0,0,0,0,0,0,0,0
"2011","Forest of Dean","E07000080","Rural (total)",22458,17122,9651,7471,148,2391,427,1964,2427,1997,430,370
"2011","Forest of Dean","E07000080","Rural town and fringe",9082,6324,3336,2988,82,1456,248,1208,1076,954,122,144
"2011","Forest of Dean","E07000080","Rural town and fringe in a sparse setting",0,0,0,0,0,0,0,0,0,0,0,0
"2011","Forest of Dean","E07000080","Rural village",8703,6841,3836,3005,49,780,148,632,906,679,227,127
"2011","Forest of Dean","E07000080","Rural village in a sparse setting",0,0,0,0,0,0,0,0,0,0,0,0
"2011","Forest of Dean","E07000080","Rural hamlet and isolated dwellings",4673,3957,2479,1478,17,155,31,124,445,364,81,99
"2011","Forest of Dean","E07000080","Rural hamlet and isolated dwellings in a sparse setting",0,0,0,0,0,0,0,0,0,0,0,0
"2011","Gloucester","E07000081","Total",50363,33858,14729,19129,557,6714,3921,2793,8755,8012,743,479
"2011","Gloucester","E07000081","Urban (total)",50363,33858,14729,19129,557,6714,3921,2793,8755,8012,743,479
"2011","Gloucester","E07000081","Urban major conurbation",0,0,0,0,0,0,0,0,0,0,0,0
"2011","Gloucester","E07000081","Urban minor conurbation",0,0,0,0,0,0,0,0,0,0,0,0
"2011","Gloucester","E07000081","Urban city and town",50363,33858,14729,19129,557,6714,3921,2793,8755,8012,743,479
"2011","Gloucester","E07000081","Urban city and town in a sparse setting",0,0,0,0,0,0,0,0,0,0,0,0
"2011","Gloucester","E07000081","Rural (total)",0,0,0,0,0,0,0,0,0,0,0,0
"2011","Gloucester","E07000081","Rural town and fringe",0,0,0,0,0,0,0,0,0,0,0,0
"2011","Gloucester","E07000081","Rural town and fringe in a sparse setting",0,0,0,0,0,0,0,0,0,0,0,0
"2011","Gloucester","E07000081","Rural village",0,0,0,0,0,0,0,0,0,0,0,0
"2011","Gloucester","E07000081","Rural village in a sparse setting",0,0,0,0,0,0,0,0,0,0,0,0
"2011","Gloucester","E07000081","Rural hamlet and isolated dwellings",0,0,0,0,0,0,0,0,0,0,0,0
"2011","Gloucester","E07000081","Rural hamlet and isolated dwellings in a sparse setting",0,0,0,0,0,0,0,0,0,0,0,0
"2011","Stroud","E07000082","Total",47794,34988,18187,16801,285,6097,4823,1274,5791,5288,503,633
"2011","Stroud","E07000082","Urban (total)",34366,24892,12540,12352,197,4768,3745,1023,4093,3769,324,416
"2011","Stroud","E07000082","Urban major conurbation",0,0,0,0,0,0,0,0,0,0,0,0
"2011","Stroud","E07000082","Urban minor conurbation",0,0,0,0,0,0,0,0,0,0,0,0
"2011","Stroud","E07000082","Urban city and town",34366,24892,12540,12352,197,4768,3745,1023,4093,3769,324,416
"2011","Stroud","E07000082","Urban city and town in a sparse setting",0,0,0,0,0,0,0,0,0,0,0,0
"2011","Stroud","E07000082","Rural (total)",13428,10096,5647,4449,88,1329,1078,251,1698,1519,179,217
"2011","Stroud","E07000082","Rural town and fringe",4646,3275,1810,1465,38,654,537,117,623,566,57,56
"2011","Stroud","E07000082","Rural town and fringe in a sparse setting",0,0,0,0,0,0,0,0,0,0,0,0
"2011","Stroud","E07000082","Rural village",5612,4351,2362,1989,43,548,441,107,575,515,60,95
"2011","Stroud","E07000082","Rural village in a sparse setting",0,0,0,0,0,0,0,0,0,0,0,0
"2011","Stroud","E07000082","Rural hamlet and isolated dwellings",3170,2470,1475,995,7,127,100,27,500,438,62,66
"2011","Stroud","E07000082","Rural hamlet and isolated dwellings in a sparse setting",0,0,0,0,0,0,0,0,0,0,0,0
"2011","Tewkesbury","E07000083","Total",35126,25844,13391,12453,330,4190,727,3463,4351,3611,740,411
"2011","Tewkesbury","E07000083","Urban (total)",25007,18009,8599,9410,229,3268,521,2747,3281,2666,615,220
"2011","Tewkesbury","E07000083","Urban major conurbation",0,0,0,0,0,0,0,0,0,0,0,0
"2011","Tewkesbury","E07000083","Urban minor conurbation",0,0,0,0,0,0,0,0,0,0,0,0
"2011","Tewkesbury","E07000083","Urban city and town",25007,18009,8599,9410,229,3268,521,2747,3281,2666,615,220
"2011","Tewkesbury","E07000083","Urban city and town in a sparse setting",0,0,0,0,0,0,0,0,0,0,0,0
"2011","Tewkesbury","E07000083","Rural (total)",10119,7835,4792,3043,101,922,206,716,1070,945,125,191
"2011","Tewkesbury","E07000083","Rural town and fringe",3471,2536,1574,962,35,547,103,444,300,267,33,53
"2011","Tewkesbury","E07000083","Rural town and fringe in a sparse setting",0,0,0,0,0,0,0,0,0,0,0,0
"2011","Tewkesbury","E07000083","Rural village",3879,3196,1937,1259,53,211,36,175,362,325,37,57
"2011","Tewkesbury","E07000083","Rural village in a sparse setting",0,0,0,0,0,0,0,0,0,0,0,0
"2011","Tewkesbury","E07000083","Rural hamlet and isolated dwellings",2769,2103,1281,822,13,164,67,97,408,353,55,81
"2011","Tewkesbury","E07000083","Rural hamlet and isolated dwellings in a sparse setting",0,0,0,0,0,0,0,0,0,0,0,0
"2011","Mendip","E07000187","Total",46157,32438,17387,15051,349,5473,1320,4153,7136,6449,687,761
"2011","Mendip","E07000187","Urban (total)",26056,17678,9012,8666,252,3534,899,2635,4295,3968,327,297
"2011","Mendip","E07000187","Urban major conurbation",0,0,0,0,0,0,0,0,0,0,0,0
"2011","Mendip","E07000187","Urban minor conurbation",0,0,0,0,0,0,0,0,0,0,0,0
"2011","Mendip","E07000187","Urban city and town",26056,17678,9012,8666,252,3534,899,2635,4295,3968,327,297
"2011","Mendip","E07000187","Urban city and town in a sparse setting",0,0,0,0,0,0,0,0,0,0,0,0
"2011","Mendip","E07000187","Rural (total)",20101,14760,8375,6385,97,1939,421,1518,2841,2481,360,464
"2011","Mendip","E07000187","Rural town and fringe",5161,3392,1915,1477,45,744,168,576,900,812,88,80
"2011","Mendip","E07000187","Rural town and fringe in a sparse setting",0,0,0,0,0,0,0,0,0,0,0,0
"2011","Mendip","E07000187","Rural village",9424,7043,4005,3038,39,931,207,724,1198,1037,161,213
"2011","Mendip","E07000187","Rural village in a sparse setting",0,0,0,0,0,0,0,0,0,0,0,0
"2011","Mendip","E07000187","Rural hamlet and isolated dwellings",5516,4325,2455,1870,13,264,46,218,743,632,111,171
"2011","Mendip","E07000187","Rural hamlet and isolated dwellings in a sparse setting",0,0,0,0,0,0,0,0,0,0,0,0
"2011","Sedgemoor","E07000188","Total",48801,34802,18320,16482,273,5951,3670,2281,7113,6380,733,662
"2011","Sedgemoor","E07000188","Urban (total)",28065,18154,8978,9176,146,4319,2567,1752,5112,4670,442,334
"2011","Sedgemoor","E07000188","Urban major conurbation",0,0,0,0,0,0,0,0,0,0,0,0
"2011","Sedgemoor","E07000188","Urban minor conurbation",0,0,0,0,0,0,0,0,0,0,0,0
"2011","Sedgemoor","E07000188","Urban city and town",28065,18154,8978,9176,146,4319,2567,1752,5112,4670,442,334
"2011","Sedgemoor","E07000188","Urban city and town in a sparse setting",0,0,0,0,0,0,0,0,0,0,0,0
"2011","Sedgemoor","E07000188","Rural (total)",20736,16648,9342,7306,127,1632,1103,529,2001,1710,291,328
"2011","Sedgemoor","E07000188","Rural town and fringe",9232,7007,3844,3163,56,1056,673,383,978,857,121,135
"2011","Sedgemoor","E07000188","Rural town and fringe in a sparse setting",0,0,0,0,0,0,0,0,0,0,0,0
"2011","Sedgemoor","E07000188","Rural village",7778,6522,3749,2773,63,463,342,121,615,525,90,115
"2011","Sedgemoor","E07000188","Rural village in a sparse setting",0,0,0,0,0,0,0,0,0,0,0,0
"2011","Sedgemoor","E07000188","Rural hamlet and isolated dwellings",3726,3119,1749,1370,8,113,88,25,408,328,80,78
"2011","Sedgemoor","E07000188","Rural hamlet and isolated dwellings in a sparse setting",0,0,0,0,0,0,0,0,0,0,0,0
"2011","South Somerset","E07000189","Total",69501,48855,26718,22137,542,9697,2811,6886,9272,7881,1391,1135
"2011","South Somerset","E07000189","Urban (total)",25363,16742,8040,8702,255,4345,1408,2937,3766,3250,516,255
"2011","South Somerset","E07000189","Urban major conurbation",0,0,0,0,0,0,0,0,0,0,0,0
"2011","South Somerset","E07000189","Urban minor conurbation",0,0,0,0,0,0,0,0,0,0,0,0
"2011","South Somerset","E07000189","Urban city and town",25363,16742,8040,8702,255,4345,1408,2937,3766,3250,516,255
"2011","South Somerset","E07000189","Urban city and town in a sparse setting",0,0,0,0,0,0,0,0,0,0,0,0
"2011","South Somerset","E07000189","Rural (total)",44138,32113,18678,13435,287,5352,1403,3949,5506,4631,875,880
"2011","South Somerset","E07000189","Rural town and fringe",23061,15951,8933,7018,173,3432,861,2571,3147,2644,503,358
"2011","South Somerset","E07000189","Rural town and fringe in a sparse setting",0,0,0,0,0,0,0,0,0,0,0,0
"2011","South Somerset","E07000189","Rural village",14049,10570,6141,4429,75,1574,443,1131,1534,1313,221,296
"2011","South Somerset","E07000189","Rural village in a sparse setting",0,0,0,0,0,0,0,0,0,0,0,0
"2011","South Somerset","E07000189","Rural hamlet and isolated dwellings",7028,5592,3604,1988,39,346,99,247,825,674,151,226
"2011","South Somerset","E07000189","Rural hamlet and isolated dwellings in a sparse setting",0,0,0,0,0,0,0,0,0,0,0,0
"2011","Taunton Deane","E07000190","Total",46907,31393,16329,15064,251,7321,5439,1882,7227,6506,721,715
"2011","Taunton Deane","E07000190","Urban (total)",34003,21530,10799,10731,155,6234,4612,1622,5586,5077,509,498
"2011","Taunton Deane","E07000190","Urban major conurbation",0,0,0,0,0,0,0,0,0,0,0,0
"2011","Taunton Deane","E07000190","Urban minor conurbation",0,0,0,0,0,0,0,0,0,0,0,0
"2011","Taunton Deane","E07000190","Urban city and town",34003,21530,10799,10731,155,6234,4612,1622,5586,5077,509,498
"2011","Taunton Deane","E07000190","Urban city and town in a sparse setting",0,0,0,0,0,0,0,0,0,0,0,0
"2011","Taunton Deane","E07000190","Rural (total)",12904,9863,5530,4333,96,1087,827,260,1641,1429,212,217
"2011","Taunton Deane","E07000190","Rural town and fringe",3564,2741,1353,1388,32,302,194,108,450,401,49,39
"2011","Taunton Deane","E07000190","Rural town and fringe in a sparse setting",0,0,0,0,0,0,0,0,0,0,0,0
"2011","Taunton Deane","E07000190","Rural village",4492,3313,1908,1405,45,584,484,100,471,416,55,79
"2011","Taunton Deane","E07000190","Rural village in a sparse setting",0,0,0,0,0,0,0,0,0,0,0,0
"2011","Taunton Deane","E07000190","Rural hamlet and isolated dwellings",4848,3809,2269,1540,19,201,149,52,720,612,108,99
"2011","Taunton Deane","E07000190","Rural hamlet and isolated dwellings in a sparse setting",0,0,0,0,0,0,0,0,0,0,0,0
"2011","West Somerset","E07000191","Total",15623,10421,7024,3397,72,2288,181,2107,2510,2189,321,332
"2011","West Somerset","E07000191","Urban (total)",5244,3563,2393,1170,32,620,53,567,958,861,97,71
"2011","West Somerset","E07000191","Urban major conurbation",0,0,0,0,0,0,0,0,0,0,0,0
"2011","West Somerset","E07000191","Urban minor conurbation",0,0,0,0,0,0,0,0,0,0,0,0
"2011","West Somerset","E07000191","Urban city and town",0,0,0,0,0,0,0,0,0,0,0,0
"2011","West Somerset","E07000191","Urban city and town in a sparse setting",5244,3563,2393,1170,32,620,53,567,958,861,97,71
"2011","West Somerset","E07000191","Rural (total)",10379,6858,4631,2227,40,1668,128,1540,1552,1328,224,261
"2011","West Somerset","E07000191","Rural town and fringe",2653,1587,984,603,15,617,56,561,401,366,35,33
"2011","West Somerset","E07000191","Rural town and fringe in a sparse setting",1020,637,478,159,1,237,19,218,122,101,21,23
"2011","West Somerset","E07000191","Rural village",2079,1499,1024,475,8,264,21,243,263,226,37,45
"2011","West Somerset","E07000191","Rural village in a sparse setting",1158,698,479,219,2,271,20,251,149,122,27,38
"2011","West Somerset","E07000191","Rural hamlet and isolated dwellings",1366,1003,632,371,8,55,5,50,255,215,40,45
"2011","West Somerset","E07000191","Rural hamlet and isolated dwellings in a sparse setting",2103,1434,1034,400,6,224,7,217,362,298,64,77
"2011","Anglesey","W06000001","Total",30594,20971,12444,8527,63,4487,3899,588,4324,3699,625,749
"2011","Anglesey","W06000001","Urban (total)",5193,2830,1471,1359,6,1374,1170,204,877,783,94,106
"2011","Anglesey","W06000001","Urban major conurbation",0,0,0,0,0,0,0,0,0,0,0,0
"2011","Anglesey","W06000001","Urban minor conurbation",0,0,0,0,0,0,0,0,0,0,0,0
"2011","Anglesey","W06000001","Urban city and town",0,0,0,0,0,0,0,0,0,0,0,0
"2011","Anglesey","W06000001","Urban city and town in a sparse setting",5193,2830,1471,1359,6,1374,1170,204,877,783,94,106
"2011","Anglesey","W06000001","Rural (total)",25401,18141,10973,7168,57,3113,2729,384,3447,2916,531,643
"2011","Anglesey","W06000001","Rural town and fringe",5179,3570,2060,1510,8,751,654,97,715,622,93,135
"2011","Anglesey","W06000001","Rural town and fringe in a sparse setting",5671,3995,2403,1592,11,810,655,155,738,629,109,117
"2011","Anglesey","W06000001","Rural village",3579,2553,1486,1067,14,434,405,29,486,430,56,92
"2011","Anglesey","W06000001","Rural village in a sparse setting",6575,4666,2830,1836,12,825,753,72,916,724,192,156
"2011","Anglesey","W06000001","Rural hamlet and isolated dwellings",1188,944,640,304,1,65,63,2,137,126,11,41
"2011","Anglesey","W06000001","Rural hamlet and isolated dwellings in a sparse setting",3209,2413,1554,859,11,228,199,29,455,385,70,102
"2011","Gwynedd","W06000002","Total",52473,34324,21168,13156,171,8561,4385,4176,8060,6978,1082,1357
"2011","Gwynedd","W06000002","Urban (total)",5966,2712,1444,1268,22,1528,819,709,1548,1418,130,156
"2011","Gwynedd","W06000002","Urban major conurbation",0,0,0,0,0,0,0,0,0,0,0,0
"2011","Gwynedd","W06000002","Urban minor conurbation",0,0,0,0,0,0,0,0,0,0,0,0
"2011","Gwynedd","W06000002","Urban city and town",5966,2712,1444,1268,22,1528,819,709,1548,1418,130,156
"2011","Gwynedd","W06000002","Urban city and town in a sparse setting",0,0,0,0,0,0,0,0,0,0,0,0
"2011","Gwynedd","W06000002","Rural (total)",46507,31612,19724,11888,149,7033,3566,3467,6512,5560,952,1201
"2011","Gwynedd","W06000002","Rural town and fringe",9189,5643,2894,2749,28,2048,1112,936,1246,1076,170,224
"2011","Gwynedd","W06000002","Rural town and fringe in a sparse setting",12818,7972,5236,2736,40,2265,1063,1202,2213,1905,308,328
"2011","Gwynedd","W06000002","Rural village",4346,3328,1815,1513,8,486,266,220,441,376,65,83
"2011","Gwynedd","W06000002","Rural village in a sparse setting",13344,9539,6375,3164,50,1769,878,891,1633,1374,259,353
"2011","Gwynedd","W06000002","Rural hamlet and isolated dwellings",1718,1335,712,623,1,108,61,47,229,195,34,45
"2011","Gwynedd","W06000002","Rural hamlet and isolated dwellings in a sparse setting",5092,3795,2692,1103,22,357,186,171,750,634,116,168
"2011","Conwy","W06000003","Total",51177,35501,20409,15092,378,5946,2592,3354,8534,7729,805,818
"2011","Conwy","W06000003","Urban (total)",35604,24374,14015,10359,302,4202,1877,2325,6229,5713,516,497
"2011","Conwy","W06000003","Urban major conurbation",0,0,0,0,0,0,0,0,0,0,0,0
"2011","Conwy","W06000003","Urban minor conurbation",0,0,0,0,0,0,0,0,0,0,0,0
"2011","Conwy","W06000003","Urban city and town",35604,24374,14015,10359,302,4202,1877,2325,6229,5713,516,497
"2011","Conwy","W06000003","Urban city and town in a sparse setting",0,0,0,0,0,0,0,0,0,0,0,0
"2011","Conwy","W06000003","Rural (total)",15573,11127,6394,4733,76,1744,715,1029,2305,2016,289,321
"2011","Conwy","W06000003","Rural town and fringe",6676,4754,2552,2202,50,778,297,481,1002,911,91,92
"2011","Conwy","W06000003","Rural town and fringe in a sparse setting",1472,908,520,388,11,318,128,190,197,167,30,38
"2011","Conwy","W06000003","Rural village",2655,1907,1114,793,8,315,160,155,359,309,50,66
"2011","Conwy","W06000003","Rural village in a sparse setting",1075,724,446,278,0,176,58,118,147,122,25,28
"2011","Conwy","W06000003","Rural hamlet and isolated dwellings",2200,1759,1082,677,4,52,31,21,331,278,53,54
"2011","Conwy","W06000003","Rural hamlet and isolated dwellings in a sparse setting",1495,1075,680,395,3,105,41,64,269,229,40,43
"2011","Denbighshire","W06000004","Total",40546,27792,14937,12855,267,5325,3283,2042,6446,5798,648,716
"2011","Denbighshire","W06000004","Urban (total)",20270,13586,7096,6490,181,2582,1479,1103,3616,3317,299,305
"2011","Denbighshire","W06000004","Urban major conurbation",0,0,0,0,0,0,0,0,0,0,0,0
"2011","Denbighshire","W06000004","Urban minor conurbation",0,0,0,0,0,0,0,0,0,0,0,0
"2011","Denbighshire","W06000004","Urban city and town",20270,13586,7096,6490,181,2582,1479,1103,3616,3317,299,305
"2011","Denbighshire","W06000004","Urban city and town in a sparse setting",0,0,0,0,0,0,0,0,0,0,0,0
"2011","Denbighshire","W06000004","Rural (total)",20276,14206,7841,6365,86,2743,1804,939,2830,2481,349,411
"2011","Denbighshire","W06000004","Rural town and fringe",11192,7443,3983,3460,62,1883,1159,724,1609,1429,180,195
"2011","Denbighshire","W06000004","Rural town and fringe in a sparse setting",0,0,0,0,0,0,0,0,0,0,0,0
"2011","Denbighshire","W06000004","Rural village",4561,3463,1936,1527,10,493,360,133,518,439,79,77
"2011","Denbighshire","W06000004","Rural village in a sparse setting",1199,797,460,337,1,215,159,56,138,119,19,48
"2011","Denbighshire","W06000004","Rural hamlet and isolated dwellings",3324,2503,1462,1041,13,152,126,26,565,494,71,91
"2011","Denbighshire","W06000004","Rural hamlet and isolated dwellings in a sparse setting",0,0,0,0,0,0,0,0,0,0,0,0
"2011","Flintshire","W06000005","Total",63781,46451,22397,24054,340,9651,7209,2442,6729,5914,815,610
"2011","Flintshire","W06000005","Urban (total)",43972,30977,14548,16429,230,7612,5444,2168,4784,4245,539,369
"2011","Flintshire","W06000005","Urban major conurbation",0,0,0,0,0,0,0,0,0,0,0,0
"2011","Flintshire","W06000005","Urban minor conurbation",0,0,0,0,0,0,0,0,0,0,0,0
"2011","Flintshire","W06000005","Urban city and town",43972,30977,14548,16429,230,7612,5444,2168,4784,4245,539,369
"2011","Flintshire","W06000005","Urban city and town in a sparse setting",0,0,0,0,0,0,0,0,0,0,0,0
"2011","Flintshire","W06000005","Rural (total)",19809,15474,7849,7625,110,2039,1765,274,1945,1669,276,241
"2011","Flintshire","W06000005","Rural town and fringe",8247,6255,2952,3303,43,1100,979,121,767,657,110,82
"2011","Flintshire","W06000005","Rural town and fringe in a sparse setting",0,0,0,0,0,0,0,0,0,0,0,0
"2011","Flintshire","W06000005","Rural village",9027,7103,3737,3366,62,873,739,134,881,752,129,108
"2011","Flintshire","W06000005","Rural village in a sparse setting",0,0,0,0,0,0,0,0,0,0,0,0
"2011","Flintshire","W06000005","Rural hamlet and isolated dwellings",2535,2116,1160,956,5,66,47,19,297,260,37,51
"2011","Flintshire","W06000005","Rural hamlet and isolated dwellings in a sparse setting",0,0,0,0,0,0,0,0,0,0,0,0
"2011","Wrexham","W06000006","Total",57029,36272,17364,18908,211,12803,10942,1861,6775,6062,713,968
"2011","Wrexham","W06000006","Urban (total)",38740,22903,10617,12286,141,10331,8828,1503,4739,4258,481,626
"2011","Wrexham","W06000006","Urban major conurbation",0,0,0,0,0,0,0,0,0,0,0,0
"2011","Wrexham","W06000006","Urban minor conurbation",0,0,0,0,0,0,0,0,0,0,0,0
"2011","Wrexham","W06000006","Urban city and town",38740,22903,10617,12286,141,10331,8828,1503,4739,4258,481,626
"2011","Wrexham","W06000006","Urban city and town in a sparse setting",0,0,0,0,0,0,0,0,0,0,0,0
"2011","Wrexham","W06000006","Rural (total)",18289,13369,6747,6622,70,2472,2114,358,2036,1804,232,342
"2011","Wrexham","W06000006","Rural town and fringe",10505,7612,3716,3896,21,1708,1463,245,976,866,110,188
"2011","Wrexham","W06000006","Rural town and fringe in a sparse setting",0,0,0,0,0,0,0,0,0,0,0,0
"2011","Wrexham","W06000006","Rural village",4419,3298,1667,1631,36,554,470,84,462,406,56,69
"2011","Wrexham","W06000006","Rural village in a sparse setting",0,0,0,0,0,0,0,0,0,0,0,0
"2011","Wrexham","W06000006","Rural hamlet and isolated dwellings",3242,2375,1306,1069,13,198,174,24,576,512,64,80
"2011","Wrexham","W06000006","Rural hamlet and isolated dwellings in a sparse setting",123,84,58,26,0,12,7,5,22,20,2,5
"2011","Powys","W06000023","Total",58345,40090,25626,14464,179,8161,5371,2790,8638,7522,1116,1277
"2011","Powys","W06000023","Urban (total)",7994,4670,2695,1975,23,2176,1512,664,1001,880,121,124
"2011","Powys","W06000023","Urban major conurbation",0,0,0,0,0,0,0,0,0,0,0,0
"2011","Powys","W06000023","Urban minor conurbation",0,0,0,0,0,0,0,0,0,0,0,0
"2011","Powys","W06000023","Urban city and town",2979,2062,1275,787,7,637,525,112,220,193,27,53
"2011","Powys","W06000023","Urban city and town in a sparse setting",5015,2608,1420,1188,16,1539,987,552,781,687,94,71
"2011","Powys","W06000023","Rural (total)",50351,35420,22931,12489,156,5985,3859,2126,7637,6642,995,1153
"2011","Powys","W06000023","Rural town and fringe",1416,934,597,337,3,228,94,134,226,183,43,25
"2011","Powys","W06000023","Rural town and fringe in a sparse setting",15765,9116,5617,3499,56,3316,1918,1398,2938,2636,302,339
"2011","Powys","W06000023","Rural village",4116,3156,1894,1262,15,396,337,59,471,354,117,78
"2011","Powys","W06000023","Rural village in a sparse setting",13486,10009,6387,3622,31,1360,994,366,1816,1579,237,270
"2011","Powys","W06000023","Rural hamlet and isolated dwellings",1568,1197,760,437,4,110,84,26,212,178,34,45
"2011","Powys","W06000023","Rural hamlet and isolated dwellings in a sparse setting",14000,11008,7676,3332,47,575,432,143,1974,1712,262,396
"2011","Ceredigion","W06000008","Total",31562,21323,13821,7502,110,3196,1008,2188,6275,5653,622,658
"2011","Ceredigion","W06000008","Urban (total)",6554,2981,1855,1126,27,1007,292,715,2422,2243,179,117
"2011","Ceredigion","W06000008","Urban major conurbation",0,0,0,0,0,0,0,0,0,0,0,0
"2011","Ceredigion","W06000008","Urban minor conurbation",0,0,0,0,0,0,0,0,0,0,0,0
"2011","Ceredigion","W06000008","Urban city and town",0,0,0,0,0,0,0,0,0,0,0,0
"2011","Ceredigion","W06000008","Urban city and town in a sparse setting",6554,2981,1855,1126,27,1007,292,715,2422,2243,179,117
"2011","Ceredigion","W06000008","Rural (total)",25008,18342,11966,6376,83,2189,716,1473,3853,3410,443,541
"2011","Ceredigion","W06000008","Rural town and fringe",0,0,0,0,0,0,0,0,0,0,0,0
"2011","Ceredigion","W06000008","Rural town and fringe in a sparse setting",5419,3213,2139,1074,17,940,318,622,1149,1051,98,100
"2011","Ceredigion","W06000008","Rural village",0,0,0,0,0,0,0,0,0,0,0,0
"2011","Ceredigion","W06000008","Rural village in a sparse setting",12030,9006,5701,3305,45,986,306,680,1756,1557,199,237
"2011","Ceredigion","W06000008","Rural hamlet and isolated dwellings",0,0,0,0,0,0,0,0,0,0,0,0
"2011","Ceredigion","W06000008","Rural hamlet and isolated dwellings in a sparse setting",7559,6123,4126,1997,21,263,92,171,948,802,146,204
"2011","Pembrokeshire","W06000009","Total",53122,36558,22307,14251,140,8312,5822,2490,7188,6180,1008,924
"2011","Pembrokeshire","W06000009","Urban (total)",12476,7331,4090,3241,28,3065,2224,841,1912,1606,306,140
"2011","Pembrokeshire","W06000009","Urban major conurbation",0,0,0,0,0,0,0,0,0,0,0,0
"2011","Pembrokeshire","W06000009","Urban minor conurbation",0,0,0,0,0,0,0,0,0,0,0,0
"2011","Pembrokeshire","W06000009","Urban city and town",12476,7331,4090,3241,28,3065,2224,841,1912,1606,306,140
"2011","Pembrokeshire","W06000009","Urban city and town in a sparse setting",0,0,0,0,0,0,0,0,0,0,0,0
"2011","Pembrokeshire","W06000009","Rural (total)",40646,29227,18217,11010,112,5247,3598,1649,5276,4574,702,784
"2011","Pembrokeshire","W06000009","Rural town and fringe",9429,5795,3250,2545,17,2203,1529,674,1327,1195,132,87
"2011","Pembrokeshire","W06000009","Rural town and fringe in a sparse setting",8339,5611,3688,1923,18,1169,755,414,1342,1186,156,199
"2011","Pembrokeshire","W06000009","Rural village",4485,3679,2166,1513,10,316,257,59,407,357,50,73
"2011","Pembrokeshire","W06000009","Rural village in a sparse setting",8415,6323,3953,2370,34,988,657,331,919,752,167,151
"2011","Pembrokeshire","W06000009","Rural hamlet and isolated dwellings",2553,1886,1177,709,7,222,178,44,369,330,39,69
"2011","Pembrokeshire","W06000009","Rural hamlet and isolated dwellings in a sparse setting",7425,5933,3983,1950,26,349,222,127,912,754,158,205
"2011","Carmarthenshire","W06000010","Total",78829,56326,32648,23678,178,11672,8833,2839,9301,8196,1105,1352
"2011","Carmarthenshire","W06000010","Urban (total)",38481,25722,14080,11642,81,7096,5146,1950,4960,4427,533,622
"2011","Carmarthenshire","W06000010","Urban major conurbation",0,0,0,0,0,0,0,0,0,0,0,0
"2011","Carmarthenshire","W06000010","Urban minor conurbation",0,0,0,0,0,0,0,0,0,0,0,0
"2011","Carmarthenshire","W06000010","Urban city and town",31551,21431,11563,9868,64,5779,4333,1446,3779,3345,434,498
"2011","Carmarthenshire","W06000010","Urban city and town in a sparse setting",6930,4291,2517,1774,17,1317,813,504,1181,1082,99,124
"2011","Carmarthenshire","W06000010","Rural (total)",40348,30604,18568,12036,97,4576,3687,889,4341,3769,572,730
"2011","Carmarthenshire","W06000010","Rural town and fringe",11012,7739,4419,3320,23,1738,1390,348,1342,1196,146,170
"2011","Carmarthenshire","W06000010","Rural town and fringe in a sparse setting",1827,1105,684,421,2,324,247,77,344,307,37,52
"2011","Carmarthenshire","W06000010","Rural village",6550,5242,3105,2137,10,728,634,94,465,408,57,105
"2011","Carmarthenshire","W06000010","Rural village in a sparse setting",7043,5098,3099,1999,24,963,721,242,834,727,107,124
"2011","Carmarthenshire","W06000010","Rural hamlet and isolated dwellings",5963,4854,2966,1888,19,416,365,51,567,477,90,107
"2011","Carmarthenshire","W06000010","Rural hamlet and isolated dwellings in a sparse setting",7953,6566,4295,2271,19,407,330,77,789,654,135,172
"2011","Swansea","W06000011","Total",103497,66259,34576,31683,308,19878,13104,6774,15260,13688,1572,1792
"2011","Swansea","W06000011","Urban (total)",91551,56423,29148,27275,282,19047,12480,6567,14203,12763,1440,1596
"2011","Swansea","W06000011","Urban major conurbation",0,0,0,0,0,0,0,0,0,0,0,0
"2011","Swansea","W06000011","Urban minor conurbation",0,0,0,0,0,0,0,0,0,0,0,0
"2011","Swansea","W06000011","Urban city and town",91551,56423,29148,27275,282,19047,12480,6567,14203,12763,1440,1596
"2011","Swansea","W06000011","Urban city and town in a sparse setting",0,0,0,0,0,0,0,0,0,0,0,0
"2011","Swansea","W06000011","Rural (total)",11946,9836,5428,4408,26,831,624,207,1057,925,132,196
"2011","Swansea","W06000011","Rural town and fringe",5566,4421,2308,2113,10,543,367,176,503,438,65,89
"2011","Swansea","W06000011","Rural town and fringe in a sparse setting",0,0,0,0,0,0,0,0,0,0,0,0
"2011","Swansea","W06000011","Rural village",3605,3048,1732,1316,13,139,119,20,356,318,38,49
"2011","Swansea","W06000011","Rural village in a sparse setting",0,0,0,0,0,0,0,0,0,0,0,0
"2011","Swansea","W06000011","Rural hamlet and isolated dwellings",2775,2367,1388,979,3,149,138,11,198,169,29,58
"2011","Swansea","W06000011","Rural hamlet and isolated dwellings in a sparse setting",0,0,0,0,0,0,0,0,0,0,0,0
"2011","Neath Port Talbot","W06000012","Total",60393,41479,21976,19503,111,11545,7496,4049,6186,5404,782,1072
"2011","Neath Port Talbot","W06000012","Urban (total)",45966,31188,16228,14960,94,8869,5619,3250,4979,4399,580,836
"2011","Neath Port Talbot","W06000012","Urban major conurbation",0,0,0,0,0,0,0,0,0,0,0,0
"2011","Neath Port Talbot","W06000012","Urban minor conurbation",0,0,0,0,0,0,0,0,0,0,0,0
"2011","Neath Port Talbot","W06000012","Urban city and town",45966,31188,16228,14960,94,8869,5619,3250,4979,4399,580,836
"2011","Neath Port Talbot","W06000012","Urban city and town in a sparse setting",0,0,0,0,0,0,0,0,0,0,0,0
"2011","Neath Port Talbot","W06000012","Rural (total)",14427,10291,5748,4543,17,2676,1877,799,1207,1005,202,236
"2011","Neath Port Talbot","W06000012","Rural town and fringe",9094,6266,3522,2744,10,1864,1261,603,800,679,121,154
"2011","Neath Port Talbot","W06000012","Rural town and fringe in a sparse setting",0,0,0,0,0,0,0,0,0,0,0,0
"2011","Neath Port Talbot","W06000012","Rural village",4258,3207,1738,1469,6,650,494,156,331,265,66,64
"2011","Neath Port Talbot","W06000012","Rural village in a sparse setting",0,0,0,0,0,0,0,0,0,0,0,0
"2011","Neath Port Talbot","W06000012","Rural hamlet and isolated dwellings",1075,818,488,330,1,162,122,40,76,61,15,18
"2011","Neath Port Talbot","W06000012","Rural hamlet and isolated dwellings in a sparse setting",0,0,0,0,0,0,0,0,0,0,0,0
"2011","Bridgend","W06000013","Total",58515,42348,20459,21889,143,8099,2332,5767,7188,6310,878,737
"2011","Bridgend","W06000013","Urban (total)",45426,32683,15758,16925,123,6417,1823,4594,5617,4942,675,586
"2011","Bridgend","W06000013","Urban major conurbation",0,0,0,0,0,0,0,0,0,0,0,0
"2011","Bridgend","W06000013","Urban minor conurbation",0,0,0,0,0,0,0,0,0,0,0,0
"2011","Bridgend","W06000013","Urban city and town",45426,32683,15758,16925,123,6417,1823,4594,5617,4942,675,586
"2011","Bridgend","W06000013","Urban city and town in a sparse setting",0,0,0,0,0,0,0,0,0,0,0,0
"2011","Bridgend","W06000013","Rural (total)",13089,9665,4701,4964,20,1682,509,1173,1571,1368,203,151
"2011","Bridgend","W06000013","Rural town and fringe",9893,7337,3565,3772,11,1226,364,862,1210,1071,139,109
"2011","Bridgend","W06000013","Rural town and fringe in a sparse setting",0,0,0,0,0,0,0,0,0,0,0,0
"2011","Bridgend","W06000013","Rural village",2616,1834,899,935,9,445,140,305,295,245,50,33
"2011","Bridgend","W06000013","Rural village in a sparse setting",0,0,0,0,0,0,0,0,0,0,0,0
"2011","Bridgend","W06000013","Rural hamlet and isolated dwellings",580,494,237,257,0,11,5,6,66,52,14,9
"2011","Bridgend","W06000013","Rural hamlet and isolated dwellings in a sparse setting",0,0,0,0,0,0,0,0,0,0,0,0
"2011","The Vale of Glamorgan","W06000014","Total",53505,38647,18954,19693,125,6354,4025,2329,7813,6780,1033,566
"2011","The Vale of Glamorgan","W06000014","Urban (total)",43388,30168,14234,15934,114,5968,3726,2242,6728,5837,891,410
"2011","The Vale of Glamorgan","W06000014","Urban major conurbation",0,0,0,0,0,0,0,0,0,0,0,0
"2011","The Vale of Glamorgan","W06000014","Urban minor conurbation",0,0,0,0,0,0,0,0,0,0,0,0
"2011","The Vale of Glamorgan","W06000014","Urban city and town",43388,30168,14234,15934,114,5968,3726,2242,6728,5837,891,410
"2011","The Vale of Glamorgan","W06000014","Urban city and town in a sparse setting",0,0,0,0,0,0,0,0,0,0,0,0
"2011","The Vale of Glamorgan","W06000014","Rural (total)",10117,8479,4720,3759,11,386,299,87,1085,943,142,156
"2011","The Vale of Glamorgan","W06000014","Rural town and fringe",3866,3159,1686,1473,6,223,158,65,447,398,49,31
"2011","The Vale of Glamorgan","W06000014","Rural town and fringe in a sparse setting",0,0,0,0,0,0,0,0,0,0,0,0
"2011","The Vale of Glamorgan","W06000014","Rural village",5469,4639,2606,2033,4,157,137,20,573,490,83,96
"2011","The Vale of Glamorgan","W06000014","Rural village in a sparse setting",0,0,0,0,0,0,0,0,0,0,0,0
"2011","The Vale of Glamorgan","W06000014","Rural hamlet and isolated dwellings",782,681,428,253,1,6,4,2,65,55,10,29
"2011","The Vale of Glamorgan","W06000014","Rural hamlet and isolated dwellings in a sparse setting",0,0,0,0,0,0,0,0,0,0,0,0
"2011","Cardiff","W06000015","Total",142557,84262,37788,46474,639,24374,13547,10827,31220,28972,2248,2062
"2011","Cardiff","W06000015","Urban (total)",140235,82245,36818,45427,638,24282,13463,10819,31035,28813,2222,2035
"2011","Cardiff","W06000015","Urban major conurbation",0,0,0,0,0,0,0,0,0,0,0,0
"2011","Cardiff","W06000015","Urban minor conurbation",0,0,0,0,0,0,0,0,0,0,0,0
"2011","Cardiff","W06000015","Urban city and town",140235,82245,36818,45427,638,24282,13463,10819,31035,28813,2222,2035
"2011","Cardiff","W06000015","Urban city and town in a sparse setting",0,0,0,0,0,0,0,0,0,0,0,0
"2011","Cardiff","W06000015","Rural (total)",2322,2017,970,1047,1,92,84,8,185,159,26,27
"2011","Cardiff","W06000015","Rural town and fringe",1871,1650,817,833,1,84,80,4,118,97,21,18
"2011","Cardiff","W06000015","Rural town and fringe in a sparse setting",0,0,0,0,0,0,0,0,0,0,0,0
"2011","Cardiff","W06000015","Rural village",451,367,153,214,0,8,4,4,67,62,5,9
"2011","Cardiff","W06000015","Rural village in a sparse setting",0,0,0,0,0,0,0,0,0,0,0,0
"2011","Cardiff","W06000015","Rural hamlet and isolated dwellings",0,0,0,0,0,0,0,0,0,0,0,0
"2011","Cardiff","W06000015","Rural hamlet and isolated dwellings in a sparse setting",0,0,0,0,0,0,0,0,0,0,0,0
"2011","Rhondda, Cynon, Taff","W06000016","Total",99663,70760,36338,34422,150,13673,6836,6837,13604,12334,1270,1476
"2011","Rhondda, Cynon, Taff","W06000016","Urban (total)",75029,53901,28046,25855,113,9020,4139,4881,10915,9980,935,1080
"2011","Rhondda, Cynon, Taff","W06000016","Urban major conurbation",0,0,0,0,0,0,0,0,0,0,0,0
"2011","Rhondda, Cynon, Taff","W06000016","Urban minor conurbation",0,0,0,0,0,0,0,0,0,0,0,0
"2011","Rhondda, Cynon, Taff","W06000016","Urban city and town",75029,53901,28046,25855,113,9020,4139,4881,10915,9980,935,1080
"2011","Rhondda, Cynon, Taff","W06000016","Urban city and town in a sparse setting",0,0,0,0,0,0,0,0,0,0,0,0
"2011","Rhondda, Cynon, Taff","W06000016","Rural (total)",24634,16859,8292,8567,37,4653,2697,1956,2689,2354,335,396
"2011","Rhondda, Cynon, Taff","W06000016","Rural town and fringe",21762,14621,7019,7602,34,4336,2536,1800,2421,2126,295,350
"2011","Rhondda, Cynon, Taff","W06000016","Rural town and fringe in a sparse setting",0,0,0,0,0,0,0,0,0,0,0,0
"2011","Rhondda, Cynon, Taff","W06000016","Rural village",1526,1186,701,485,1,184,105,79,121,99,22,34
"2011","Rhondda, Cynon, Taff","W06000016","Rural village in a sparse setting",0,0,0,0,0,0,0,0,0,0,0,0
"2011","Rhondda, Cynon, Taff","W06000016","Rural hamlet and isolated dwellings",1346,1052,572,480,2,133,56,77,147,129,18,12
"2011","Rhondda, Cynon, Taff","W06000016","Rural hamlet and isolated dwellings in a sparse setting",0,0,0,0,0,0,0,0,0,0,0,0
"2011","Merthyr Tydfil","W06000024","Total",24264,15843,8277,7566,42,5118,2379,2739,2809,2500,309,452
"2011","Merthyr Tydfil","W06000024","Urban (total)",21182,13794,7084,6710,40,4497,2108,2389,2447,2177,270,404
"2011","Merthyr Tydfil","W06000024","Urban major conurbation",0,0,0,0,0,0,0,0,0,0,0,0
"2011","Merthyr Tydfil","W06000024","Urban minor conurbation",0,0,0,0,0,0,0,0,0,0,0,0
"2011","Merthyr Tydfil","W06000024","Urban city and town",21182,13794,7084,6710,40,4497,2108,2389,2447,2177,270,404
"2011","Merthyr Tydfil","W06000024","Urban city and town in a sparse setting",0,0,0,0,0,0,0,0,0,0,0,0
"2011","Merthyr Tydfil","W06000024","Rural (total)",3082,2049,1193,856,2,621,271,350,362,323,39,48
"2011","Merthyr Tydfil","W06000024","Rural town and fringe",2739,1801,1040,761,1,557,252,305,336,300,36,44
"2011","Merthyr Tydfil","W06000024","Rural town and fringe in a sparse setting",0,0,0,0,0,0,0,0,0,0,0,0
"2011","Merthyr Tydfil","W06000024","Rural village",242,167,102,65,0,51,14,37,21,18,3,3
"2011","Merthyr Tydfil","W06000024","Rural village in a sparse setting",0,0,0,0,0,0,0,0,0,0,0,0
"2011","Merthyr Tydfil","W06000024","Rural hamlet and isolated dwellings",101,81,51,30,1,13,5,8,5,5,0,1
"2011","Merthyr Tydfil","W06000024","Rural hamlet and isolated dwellings in a sparse setting",0,0,0,0,0,0,0,0,0,0,0,0
"2011","Caerphilly","W06000018","Total",74479,51632,24188,27444,216,13962,10464,3498,7995,7178,817,674
"2011","Caerphilly","W06000018","Urban (total)",58401,40926,19008,21918,183,10597,7957,2640,6167,5546,621,528
"2011","Caerphilly","W06000018","Urban major conurbation",0,0,0,0,0,0,0,0,0,0,0,0
"2011","Caerphilly","W06000018","Urban minor conurbation",0,0,0,0,0,0,0,0,0,0,0,0
"2011","Caerphilly","W06000018","Urban city and town",58401,40926,19008,21918,183,10597,7957,2640,6167,5546,621,528
"2011","Caerphilly","W06000018","Urban city and town in a sparse setting",0,0,0,0,0,0,0,0,0,0,0,0
"2011","Caerphilly","W06000018","Rural (total)",16078,10706,5180,5526,33,3365,2507,858,1828,1632,196,146
"2011","Caerphilly","W06000018","Rural town and fringe",13150,8342,4010,4332,28,3131,2319,812,1534,1378,156,115
"2011","Caerphilly","W06000018","Rural town and fringe in a sparse setting",0,0,0,0,0,0,0,0,0,0,0,0
"2011","Caerphilly","W06000018","Rural village",2469,1997,979,1018,4,178,132,46,264,230,34,26
"2011","Caerphilly","W06000018","Rural village in a sparse setting",0,0,0,0,0,0,0,0,0,0,0,0
"2011","Caerphilly","W06000018","Rural hamlet and isolated dwellings",459,367,191,176,1,56,56,0,30,24,6,5
"2011","Caerphilly","W06000018","Rural hamlet and isolated dwellings in a sparse setting",0,0,0,0,0,0,0,0,0,0,0,0
"2011","Blaenau Gwent","W06000019","Total",30416,18884,10019,8865,40,7284,3364,3920,3892,3480,412,316
"2011","Blaenau Gwent","W06000019","Urban (total)",26315,16136,8545,7591,32,6680,3151,3529,3204,2861,343,263
"2011","Blaenau Gwent","W06000019","Urban major conurbation",0,0,0,0,0,0,0,0,0,0,0,0
"2011","Blaenau Gwent","W06000019","Urban minor conurbation",0,0,0,0,0,0,0,0,0,0,0,0
"2011","Blaenau Gwent","W06000019","Urban city and town",26315,16136,8545,7591,32,6680,3151,3529,3204,2861,343,263
"2011","Blaenau Gwent","W06000019","Urban city and town in a sparse setting",0,0,0,0,0,0,0,0,0,0,0,0
"2011","Blaenau Gwent","W06000019","Rural (total)",4101,2748,1474,1274,8,604,213,391,688,619,69,53
"2011","Blaenau Gwent","W06000019","Rural town and fringe",3200,2109,1154,955,6,500,178,322,541,485,56,44
"2011","Blaenau Gwent","W06000019","Rural town and fringe in a sparse setting",0,0,0,0,0,0,0,0,0,0,0,0
"2011","Blaenau Gwent","W06000019","Rural village",516,334,174,160,0,99,33,66,77,72,5,6
"2011","Blaenau Gwent","W06000019","Rural village in a sparse setting",0,0,0,0,0,0,0,0,0,0,0,0
"2011","Blaenau Gwent","W06000019","Rural hamlet and isolated dwellings",385,305,146,159,2,5,2,3,70,62,8,3
"2011","Blaenau Gwent","W06000019","Rural hamlet and isolated dwellings in a sparse setting",0,0,0,0,0,0,0,0,0,0,0,0
"2011","Torfaen","W06000020","Total",38524,25518,12176,13342,199,9100,3840,5260,3315,2894,421,392
"2011","Torfaen","W06000020","Urban (total)",34962,23066,10818,12248,195,8359,3540,4819,2982,2593,389,360
"2011","Torfaen","W06000020","Urban major conurbation",0,0,0,0,0,0,0,0,0,0,0,0
"2011","Torfaen","W06000020","Urban minor conurbation",0,0,0,0,0,0,0,0,0,0,0,0
"2011","Torfaen","W06000020","Urban city and town",34962,23066,10818,12248,195,8359,3540,4819,2982,2593,389,360
"2011","Torfaen","W06000020","Urban city and town in a sparse setting",0,0,0,0,0,0,0,0,0,0,0,0
"2011","Torfaen","W06000020","Rural (total)",3562,2452,1358,1094,4,741,300,441,333,301,32,32
"2011","Torfaen","W06000020","Rural town and fringe",3040,2069,1142,927,4,654,295,359,284,254,30,29
"2011","Torfaen","W06000020","Rural town and fringe in a sparse setting",0,0,0,0,0,0,0,0,0,0,0,0
"2011","Torfaen","W06000020","Rural village",223,140,77,63,0,69,1,68,12,11,1,2
"2011","Torfaen","W06000020","Rural village in a sparse setting",0,0,0,0,0,0,0,0,0,0,0,0
"2011","Torfaen","W06000020","Rural hamlet and isolated dwellings",299,243,139,104,0,18,4,14,37,36,1,1
"2011","Torfaen","W06000020","Rural hamlet and isolated dwellings in a sparse setting",0,0,0,0,0,0,0,0,0,0,0,0
"2011","Monmouthshire","W06000021","Total",38233,28142,15269,12873,141,5288,1590,3698,4130,3651,479,532
"2011","Monmouthshire","W06000021","Urban (total)",20846,14280,7596,6684,84,3939,1208,2731,2310,2031,279,233
"2011","Monmouthshire","W06000021","Urban major conurbation",0,0,0,0,0,0,0,0,0,0,0,0
"2011","Monmouthshire","W06000021","Urban minor conurbation",0,0,0,0,0,0,0,0,0,0,0,0
"2011","Monmouthshire","W06000021","Urban city and town",20846,14280,7596,6684,84,3939,1208,2731,2310,2031,279,233
"2011","Monmouthshire","W06000021","Urban city and town in a sparse setting",0,0,0,0,0,0,0,0,0,0,0,0
"2011","Monmouthshire","W06000021","Rural (total)",17387,13862,7673,6189,57,1349,382,967,1820,1620,200,299
"2011","Monmouthshire","W06000021","Rural town and fringe",6876,5425,2744,2681,27,726,182,544,631,563,68,67
"2011","Monmouthshire","W06000021","Rural town and fringe in a sparse setting",0,0,0,0,0,0,0,0,0,0,0,0
"2011","Monmouthshire","W06000021","Rural village",4381,3568,1949,1619,15,375,123,252,356,327,29,67
"2011","Monmouthshire","W06000021","Rural village in a sparse setting",0,0,0,0,0,0,0,0,0,0,0,0
"2011","Monmouthshire","W06000021","Rural hamlet and isolated dwellings",6130,4869,2980,1889,15,248,77,171,833,730,103,165
"2011","Monmouthshire","W06000021","Rural hamlet and isolated dwellings in a sparse setting",0,0,0,0,0,0,0,0,0,0,0,0
"2011","Newport","W06000022","Total",61172,39272,18229,21043,325,12122,5981,6141,8572,7870,702,881
"2011","Newport","W06000022","Urban (total)",53866,33545,15392,18153,307,11403,5574,5829,7818,7184,634,793
"2011","Newport","W06000022","Urban major conurbation",0,0,0,0,0,0,0,0,0,0,0,0
"2011","Newport","W06000022","Urban minor conurbation",0,0,0,0,0,0,0,0,0,0,0,0
"2011","Newport","W06000022","Urban city and town",53866,33545,15392,18153,307,11403,5574,5829,7818,7184,634,793
"2011","Newport","W06000022","Urban city and town in a sparse setting",0,0,0,0,0,0,0,0,0,0,0,0
"2011","Newport","W06000022","Rural (total)",7306,5727,2837,2890,18,719,407,312,754,686,68,88
"2011","Newport","W06000022","Rural town and fringe",5171,3874,1739,2135,14,651,360,291,574,527,47,58
"2011","Newport","W06000022","Rural town and fringe in a sparse setting",0,0,0,0,0,0,0,0,0,0,0,0
"2011","Newport","W06000022","Rural village",1659,1441,866,575,4,62,44,18,134,121,13,18
"2011","Newport","W06000022","Rural village in a sparse setting",0,0,0,0,0,0,0,0,0,0,0,0
"2011","Newport","W06000022","Rural hamlet and isolated dwellings",476,412,232,180,0,6,3,3,46,38,8,12
"2011","Newport","W06000022","Rural hamlet and isolated dwellings in a sparse setting",0,0,0,0,0,0,0,0,0,0,0,0

